ID,Year,Semester,Course Number,Gender,AS,StudentsGrade,InstructorsGrade,Difference
31C02,2016,Spring,MATH 2222,1,test1,42,18,-24
41A15,2016,Spring,MATH1120,0,test3,70,18,-52
21B3,2016,Spring,192,0,quiz1,50,20,-30
21B13,2016,Spring,192,1,quiz4,50,20,-30
21C9,2016,Spring,192,1,quiz6,50,20,-30
23A14,2016,Fall,MAT192,0,Quiz2,60,20,-40
21B27,2016,Spring,192,0,quiz6,60,20,-40
21D5,2016,Spring,320,0,quiz1,60,20,-40
23B11,2016,Fall,MAT192,0,Quiz2,70,20,-50
21B24,2016,Spring,192,1,quiz5,70,20,-50
31A08,2016,Spring,MATH 2204,0,Final,80,20,-60
23B7,2016,Fall,MAT192,1,Quiz2,80,20,-60
23B7,2016,Fall,MAT192,1,Quiz8,80,20,-60
21B25,2016,Spring,192,1,quiz6,80,20,-60
21B22,2016,Spring,192,0,quiz2,100,20,-80
41A15,2016,Spring,MATH1120,0,Final,63,21,-42
41A15,2016,Spring,MATH1120,0,test1,70,21,-49
31A03,2016,Spring,MATH 2204,1,Final,50,22,-28
11A9,2016,Spring,Math 1111,0,Quiz4,54,22,-32
13A17,2016,Fall,Math1113,1,Quiz8,81,22,-59
21B24,2016,Spring,192,1,final,65,23,-42
31A06,2016,Spring,MATH 2204,0,test1,75,23,-52
31B22,2016,Spring,MATH 2204,1,FINAL,70,24,-46
31B03,2016,Spring,MATH 2204,0,FINAL,80,24,-56
13C16,2016,Fall,Math1111,0,Quiz1,60,27,-33
13C16,2016,Fall,Math1111,0,Quiz2,60,27,-33
13C16,2016,Fall,Math1111,0,Quiz4,60,27,-33
13C16,2016,Fall,Math1111,0,Quiz5,60,27,-33
13C16,2016,Fall,Math1111,0,Test2,60,27,-33
31A12,2016,Spring,MATH 2204,0,test1,70,28,-42
23A2,2016,Fall,MAT192,1,Test1,38,30,-8
21D6,2016,Spring,320,1,quiz3,40,30,-10
23A15,2016,Fall,MAT192,0,Quiz5,50,30,-20
23B17,2016,Fall,MAT192,0,Quiz4,50,30,-20
23A20,2016,Fall,MAT192,1,Quiz5,50,30,-20
21B18,2016,Spring,192,1,quiz3,50,30,-20
21B23,2016,Spring,192,1,quiz6,50,30,-20
21C11,2016,Spring,192,1,quiz6,50,30,-20
23A20,2016,Fall,MAT192,1,Quiz2,60,30,-30
21B17,2016,Spring,192,1,quiz2,60,30,-30
21B5,2016,Spring,192,1,quiz3,60,30,-30
21C18,2016,Spring,192,1,quiz6,60,30,-30
23B17,2016,Fall,MAT192,0,Quiz7,70,30,-40
21A3,2016,Spring,191,0,quiz8,70,30,-40
23A2,2016,Fall,MAT192,1,Quiz3,70,30,-40
23A2,2016,Fall,MAT192,1,Quiz8,70,30,-40
23A7,2016,Fall,MAT192,1,Quiz8,70,30,-40
21C7,2016,Spring,192,1,quiz6,70,30,-40
21C25,2016,Spring,192,1,quiz6,75,30,-45
23B11,2016,Fall,MAT192,0,Quiz3,80,30,-50
23A10,2016,Fall,MAT192,1,Quiz2,80,30,-50
23B7,2016,Fall,MAT192,1,Quiz4,80,30,-50
21B17,2016,Spring,192,1,quiz1,80,30,-50
21C4,2016,Spring,192,1,quiz6,80,30,-50
21B16,2016,Spring,192,1,quiz2,90,30,-60
21B9,2016,Spring,192,1,quiz6,90,30,-60
23B8,2016,Fall,MAT192,1,Quiz8,100,30,-70
21B17,2016,Spring,192,1,quiz6,100,30,-70
21B24,2016,Spring,192,1,quiz2,100,30,-70
21B24,2016,Spring,192,1,quiz3,100,30,-70
21B25,2016,Spring,192,1,quiz2,100,30,-70
13B2,2016,Fall,Math3650,1,Quiz2,60,31,-29
13B25,2016,Fall,Math3650,1,Quiz5,60,31,-29
13B4,2016,Fall,Math3650,1,Test2,60,31,-29
41A20,2016,Spring,MATH1120,1,Final,33,32,-1
31A07,2016,Spring,MATH 2204,1,Final,75,32,-43
11A16,2016,Spring,Math 1111,1,Quiz4,44,33,-11
31A09,2016,Spring,MATH 2204,0,quiz2,50,33,-17
13C13,2016,Fall,Math1111,0,Quiz1,70,33,-37
13C13,2016,Fall,Math1111,0,Quiz2,70,33,-37
13C14,2016,Fall,Math1111,0,Quiz4,70,33,-37
13C14,2016,Fall,Math1111,0,Quiz5,70,33,-37
13C14,2016,Fall,Math1111,0,Test2,70,33,-37
21B28,2016,Spring,192,1,final,75,33,-42
23A20,2016,Fall,MAT192,1,Test1,45,34,-11
31B06,2016,Spring,MATH 2204,1,FINAL,70,34,-36
13C2,2016,Fall,Math1111,1,Quiz6,47,35,-12
13C2,2016,Fall,Math1111,1,Quiz7,47,35,-12
13C2,2016,Fall,Math1111,1,Test3,47,35,-12
13A1,2016,Fall,Math1113,1,Final,76,35,-41
21B2,2016,Spring,192,1,test1,84,35,-49
11C6,2016,Spring,Math 2470,0,test4,54,36,-18
31B12,2016,Spring,MATH 2204,0,test2,75,36,-39
13A18,2016,Fall,Math1113,1,Quiz6,55,37,-18
13A18,2016,Fall,Math1113,1,Test3,55,37,-18
13C1,2016,Fall,Math1111,0,Test1,70,37,-33
13C13,2016,Fall,Math1111,0,Final,75,37,-38
13C13,2016,Fall,Math1111,0,Quiz8,75,37,-38
13B6,2016,Fall,Math3650,1,Quiz2,80,38,-42
13B7,2016,Fall,Math3650,1,Quiz5,80,38,-42
13B8,2016,Fall,Math3650,1,Test2,80,38,-42
31B01,2016,Spring,MATH 2204,1,FINAL,90,38,-52
23B11,2016,Fall,MAT192,0,Test1,64,39,-25
41A20,2016,Spring,MATH1120,1,test2,70,39,-31
23B8,2016,Fall,MAT192,1,Test1,75,39,-36
21B9,2016,Spring,192,1,test2,75,39,-36
13A2,2016,Fall,Math1113,0,Final,77,39,-38
23B8,2016,Fall,MAT192,1,Quiz1,40,40,0
21B28,2016,Spring,192,1,quiz1,40,40,0
21C23,2016,Spring,192,0,quiz3,50,40,-10
21D3,2016,Spring,320,0,quiz3,50,40,-10
23A7,2016,Fall,MAT192,1,Quiz5,50,40,-10
11A16,2016,Spring,Math 1111,1,Test2,50,40,-10
21B9,2016,Spring,192,1,quiz1,50,40,-10
21B9,2016,Spring,192,1,quiz5,50,40,-10
23B16,2016,Fall,MAT192,0,Quiz3,60,40,-20
21C22,2016,Spring,192,0,quiz1,60,40,-20
21D4,2016,Spring,320,0,quiz3,60,40,-20
21B4,2016,Spring,192,1,quiz2,60,40,-20
13A3,2016,Fall,Math1113,1,Final,64,40,-24
13C1,2016,Fall,Math1111,0,Quiz3,70,40,-30
13C14,2016,Fall,Math1111,0,Quiz6,70,40,-30
13C14,2016,Fall,Math1111,0,Quiz7,70,40,-30
13C14,2016,Fall,Math1111,0,Test3,70,40,-30
11A9,2016,Spring,Math 1111,0,Test2,70,40,-30
23A10,2016,Fall,MAT192,1,Quiz5,70,40,-30
11A17,2016,Spring,Math 1111,1,Test2,70,40,-30
21B11,2016,Spring,192,1,quiz2,70,40,-30
21B2,2016,Spring,192,1,quiz1,70,40,-30
21D13,2016,Spring,320,1,quiz3,70,40,-30
23B11,2016,Fall,MAT192,0,Quiz4,80,40,-40
21A2,2016,Spring,191,0,quiz4,80,40,-40
31B19,2016,Spring,MATH 2204,0,quiz2,80,40,-40
21C7,2016,Spring,192,1,quiz3,80,40,-40
21B19,2016,Spring,192,0,quiz1,85,40,-45
21C13,2016,Spring,192,0,quiz1,90,40,-50
21C13,2016,Spring,192,0,quiz2,90,40,-50
21C2,2016,Spring,192,0,quiz3,90,40,-50
31B14,2016,Spring,MATH 2204,0,quiz2,90,40,-50
21C20,2016,Spring,192,1,quiz3,90,40,-50
21C20,2016,Spring,192,1,quiz6,90,40,-50
23A14,2016,Fall,MAT192,0,Quiz8,100,40,-60
21A1,2016,Spring,191,0,quiz6,100,40,-60
21B26,2016,Spring,192,0,quiz1,100,40,-60
21B4,2016,Spring,192,1,quiz1,100,40,-60
11A11,2016,Spring,Math 1111,0,Quiz4,34,41,7
21C6,2016,Spring,192,0,test2,51,41,-10
11A15,2016,Spring,Math 1111,1,Quiz1,55,41,-14
13A4,2016,Fall,Math1113,0,Final,66,41,-25
31B22,2016,Spring,MATH 2204,1,test1,70,41,-29
13C14,2016,Fall,Math1111,0,Final,41,42,1
13C14,2016,Fall,Math1111,0,Quiz8,41,42,1
23B17,2016,Fall,MAT192,0,Test1,61,42,-19
11A12,2016,Spring,Math 1111,1,Quiz4,45,43,-2
21D12,2016,Spring,320,1,test1,50,43,-7
13A22,2016,Fall,Math1113,0,Quiz7,59,43,-16
13C15,2016,Fall,Math1111,0,Quiz6,80,43,-37
13C15,2016,Fall,Math1111,0,Quiz7,80,43,-37
13C15,2016,Fall,Math1111,0,Test3,80,43,-37
21B4,2016,Spring,192,1,test3,93,43,-50
21B4,2016,Spring,192,1,test1,95,43,-52
31A04,2016,Spring,MATH 2204,0,Final,55,44,-11
31B16,2016,Spring,MATH 2204,0,quiz1,60,44,-16
21B25,2016,Spring,192,1,test3,60,44,-16
31B13,2016,Spring,MATH 2204,1,FINAL,65,44,-21
31B12,2016,Spring,MATH 2204,0,test1,70,44,-26
13A13,2016,Fall,Math1113,0,Quiz7,76,44,-32
31A04,2016,Spring,MATH 2204,0,quiz2,90,44,-46
11A10,2016,Spring,Math 1111,0,Test2,40,45,5
31C04,2016,Spring,MATH 2222,0,test1,42,45,3
23A20,2016,Fall,MAT192,1,Quiz4,50,45,-5
23B2,2016,Fall,MAT192,1,Test1,50,45,-5
13A12,2016,Fall,Math1113,0,Quiz6,51,45,-6
13A12,2016,Fall,Math1113,0,Test3,51,45,-6
13C5,2016,Fall,Math1111,1,Test1,65,45,-20
23A10,2016,Fall,MAT192,1,Test1,68,45,-23
23B7,2016,Fall,MAT192,1,Test1,68,45,-23
31C02,2016,Spring,MATH 2222,1,FINAL,68,45,-23
23B11,2016,Fall,MAT192,0,Quiz7,70,45,-25
13C4,2016,Fall,Math1111,1,Quiz4,70,45,-25
13C4,2016,Fall,Math1111,1,Quiz5,70,45,-25
13C4,2016,Fall,Math1111,1,Test2,70,45,-25
21B17,2016,Spring,192,1,test3,70,45,-25
31B22,2016,Spring,MATH 2204,1,test2,70,45,-25
11A2,2016,Spring,Math 1111,0,Quiz4,40,46,6
13A3,2016,Fall,Math1113,1,Quiz6,65,46,-19
13A3,2016,Fall,Math1113,1,Test3,65,46,-19
13A6,2016,Fall,Math1113,1,Final,68,46,-22
13A6,2016,Fall,Math1113,1,Quiz7,68,46,-22
13A5,2016,Fall,Math1113,0,Final,77,46,-31
21B29,2016,Spring,192,1,test1,85,46,-39
13C15,2016,Fall,Math1111,0,Final,40,47,7
13C15,2016,Fall,Math1111,0,Quiz8,40,47,7
41A32,2016,Spring,MATH1120,1,Final,61,47,-14
13C5,2016,Fall,Math1111,1,Quiz4,70,47,-23
13C5,2016,Fall,Math1111,1,Quiz5,70,47,-23
13C5,2016,Fall,Math1111,1,Test2,70,47,-23
11A1,2016,Spring,Math 1111,0,final,72,47,-25
13B6,2016,Fall,Math3650,1,Quiz1,81,47,-34
13B6,2016,Fall,Math3650,1,Quiz4,81,47,-34
13B8,2016,Fall,Math3650,1,Test1,81,47,-34
21B25,2016,Spring,192,1,final,90,47,-43
11A13,2016,Spring,Math 1111,1,Quiz4,59,48,-11
41A22,2016,Spring,MATH1120,1,Final,66,48,-18
31B05,2016,Spring,MATH 2204,0,test1,70,48,-22
13A15,2016,Fall,Math1113,1,Quiz7,71,48,-23
21C13,2016,Spring,192,0,final,73,48,-25
13A2,2016,Fall,Math1113,0,Quiz6,75,48,-27
13A2,2016,Fall,Math1113,0,Test3,75,48,-27
21B8,2016,Spring,192,1,test1,78,48,-30
21B4,2016,Spring,192,1,test2,95,48,-47
21D5,2016,Spring,320,0,test1,52,49,-3
13A4,2016,Fall,Math1113,0,Quiz2,58,49,-9
13A4,2016,Fall,Math1113,0,Quiz5,58,49,-9
13A4,2016,Fall,Math1113,0,Test2,58,49,-9
13A8,2016,Fall,Math1113,0,Final,60,49,-11
11C11,2016,Spring,Math 2470,1,test2,60,49,-11
13C13,2016,Fall,Math1111,0,Test1,65,49,-16
13C14,2016,Fall,Math1111,0,Quiz1,65,49,-16
13C14,2016,Fall,Math1111,0,Quiz2,65,49,-16
13C14,2016,Fall,Math1111,0,Quiz3,65,49,-16
23A18,2016,Fall,MAT192,0,Test1,73,49,-24
13C6,2016,Fall,Math1111,1,Quiz1,73,49,-24
13C6,2016,Fall,Math1111,1,Quiz2,73,49,-24
13C6,2016,Fall,Math1111,1,Quiz3,73,49,-24
13C7,2016,Fall,Math1111,1,Test1,73,49,-24
13B21,2016,Fall,Math3650,1,Quiz1,75,49,-26
13B21,2016,Fall,Math3650,1,Quiz4,75,49,-26
13B21,2016,Fall,Math3650,1,Quiz6,75,49,-26
13B21,2016,Fall,Math3650,1,Test1,75,49,-26
13B21,2016,Fall,Math3650,1,Test3,75,49,-26
13A21,2016,Fall,Math1113,0,Quiz7,76,49,-27
21D4,2016,Spring,320,0,test2,80,49,-31
13C5,2016,Fall,Math1111,1,Quiz1,80,49,-31
13C5,2016,Fall,Math1111,1,Quiz2,80,49,-31
13C5,2016,Fall,Math1111,1,Quiz3,80,49,-31
13C6,2016,Fall,Math1111,1,Test1,80,49,-31
21B24,2016,Spring,192,1,test1,83,49,-34
21C7,2016,Spring,192,1,test2,90,49,-41
41A18,2016,Spring,MATH1120,1,test1,37,50,13
11A3,2016,Spring,Math 1111,0,Quiz4,38,50,12
23A18,2016,Fall,MAT192,0,Quiz5,40,50,10
23B14,2016,Fall,MAT192,1,Quiz1,40,50,10
21D9,2016,Spring,320,1,quiz6,40,50,10
23A18,2016,Fall,MAT192,0,Quiz1,50,50,0
23B16,2016,Fall,MAT192,0,Quiz1,50,50,0
23B16,2016,Fall,MAT192,0,Quiz5,50,50,0
23B17,2016,Fall,MAT192,0,Quiz6,50,50,0
23B4,2016,Fall,MAT192,0,Quiz5,50,50,0
21C6,2016,Spring,192,0,quiz1,50,50,0
21D14,2016,Spring,320,0,quiz4,50,50,0
21D2,2016,Spring,320,0,quiz4,50,50,0
23B5,2016,Fall,MAT192,1,Quiz4,50,50,0
23B5,2016,Fall,MAT192,1,Quiz7,50,50,0
21B11,2016,Spring,192,1,quiz1,50,50,0
21B13,2016,Spring,192,1,quiz2,50,50,0
21B6,2016,Spring,192,1,quiz3,50,50,0
21B9,2016,Spring,192,1,quiz2,50,50,0
21C21,2016,Spring,192,1,quiz3,50,50,0
21B22,2016,Spring,192,0,quiz5,60,50,-10
21B4,2016,Spring,192,1,quiz3,60,50,-10
31B15,2016,Spring,MATH 2204,1,quiz2,60,50,-10
31A17,2016,Spring,MATH 2204,0,Final,69,50,-19
23B11,2016,Fall,MAT192,0,Quiz5,70,50,-20
23B17,2016,Fall,MAT192,0,Test2,70,50,-20
21C24,2016,Spring,192,0,quiz2,70,50,-20
21C24,2016,Spring,192,0,quiz3,70,50,-20
21C8,2016,Spring,192,0,quiz3,70,50,-20
21D4,2016,Spring,320,0,quiz1,70,50,-20
23B2,2016,Fall,MAT192,1,Quiz5,70,50,-20
23B7,2016,Fall,MAT192,1,Quiz5,70,50,-20
23B7,2016,Fall,MAT192,1,Quiz7,70,50,-20
23B8,2016,Fall,MAT192,1,Quiz5,70,50,-20
23B8,2016,Fall,MAT192,1,Quiz6,70,50,-20
21B12,2016,Spring,192,1,quiz2,70,50,-20
21C7,2016,Spring,192,1,quiz2,70,50,-20
31B21,2016,Spring,MATH 2204,1,quiz2,70,50,-20
41A18,2016,Spring,MATH1120,1,Final,74,50,-24
21C25,2016,Spring,192,1,quiz3,75,50,-25
13A9,2016,Fall,Math1113,1,Final,77,50,-27
13A9,2016,Fall,Math1113,1,Quiz7,78,50,-28
23B17,2016,Fall,MAT192,0,Quiz3,80,50,-30
21A2,2016,Spring,191,0,quiz2,80,50,-30
21A2,2016,Spring,191,0,quiz7,80,50,-30
21B20,2016,Spring,192,0,quiz1,80,50,-30
21C10,2016,Spring,192,0,quiz3,80,50,-30
21C15,2016,Spring,192,0,quiz1,80,50,-30
21C16,2016,Spring,192,0,quiz2,80,50,-30
21D4,2016,Spring,320,0,quiz4,80,50,-30
23B5,2016,Fall,MAT192,1,Quiz3,80,50,-30
21B5,2016,Spring,192,1,quiz1,80,50,-30
21C25,2016,Spring,192,1,quiz2,80,50,-30
21C4,2016,Spring,192,1,quiz2,80,50,-30
21C4,2016,Spring,192,1,quiz3,80,50,-30
21D13,2016,Spring,320,1,quiz4,80,50,-30
21D15,2016,Spring,320,1,quiz4,80,50,-30
23A10,2016,Fall,MAT192,1,Final,81,50,-31
21C2,2016,Spring,192,0,quiz6,90,50,-40
31B10,2016,Spring,MATH 2204,0,quiz2,90,50,-40
21B25,2016,Spring,192,1,quiz3,90,50,-40
21C1,2016,Spring,192,1,quiz2,90,50,-40
21C20,2016,Spring,192,1,test1,90,50,-40
23A12,2016,Fall,MAT192,0,Quiz4,100,50,-50
21A2,2016,Spring,191,0,quiz1,100,50,-50
21B22,2016,Spring,192,0,quiz1,100,50,-50
21B3,2016,Spring,192,0,quiz5,100,50,-50
21C14,2016,Spring,192,0,quiz1,100,50,-50
21C16,2016,Spring,192,0,quiz3,100,50,-50
21C5,2016,Spring,192,0,quiz1,100,50,-50
21C6,2016,Spring,192,0,quiz3,100,50,-50
23A19,2016,Fall,MAT192,1,Quiz5,100,50,-50
23A3,2016,Fall,MAT192,1,Quiz6,100,50,-50
21C1,2016,Spring,192,1,quiz1,100,50,-50
21C17,2016,Spring,192,1,quiz3,100,50,-50
21C9,2016,Spring,192,1,quiz3,100,50,-50
21D10,2016,Spring,320,1,quiz1,100,50,-50
21D10,2016,Spring,320,1,quiz4,100,50,-50
21D9,2016,Spring,320,1,quiz4,100,50,-50
21B17,2016,Spring,192,1,test1,67,51,-16
13C8,2016,Fall,Math1111,1,Final,70,51,-19
13C8,2016,Fall,Math1111,1,Quiz8,70,51,-19
13A16,2016,Fall,Math1113,1,Quiz7,72,51,-21
13A20,2016,Fall,Math1113,0,Quiz6,75,51,-24
13A20,2016,Fall,Math1113,0,Test3,75,51,-24
41A27,2016,Spring,MATH1120,1,test3,78,51,-27
13A14,2016,Fall,Math1113,1,Quiz8,81,51,-30
13A14,2016,Fall,Math1113,1,Quiz2,86,51,-35
13A14,2016,Fall,Math1113,1,Quiz5,86,51,-35
13A14,2016,Fall,Math1113,1,Test2,86,51,-35
21B7,2016,Spring,192,1,test1,90,51,-39
13A6,2016,Fall,Math1113,1,Quiz8,93,51,-42
13A20,2016,Fall,Math1113,0,Quiz8,57,52,-5
13C7,2016,Fall,Math1111,1,Quiz1,70,52,-18
13C7,2016,Fall,Math1111,1,Quiz2,70,52,-18
13C7,2016,Fall,Math1111,1,Quiz4,70,52,-18
13C7,2016,Fall,Math1111,1,Quiz5,70,52,-18
13C7,2016,Fall,Math1111,1,Test2,70,52,-18
21B20,2016,Spring,192,0,test2,72,52,-20
21C7,2016,Spring,192,1,final,73,52,-21
31A15,2016,Spring,MATH 2204,1,test1,75,52,-23
11A2,2016,Spring,Math 1111,0,Test2,80,52,-28
21A2,2016,Spring,191,0,final,80,52,-28
21B26,2016,Spring,192,0,test1,84,52,-32
13A2,2016,Fall,Math1113,0,Quiz8,93,52,-41
11A4,2016,Spring,Math 1111,0,Quiz4,42,53,11
31B02,2016,Spring,MATH 2204,0,test1,50,53,3
23B5,2016,Fall,MAT192,1,Test1,60,53,-7
41A27,2016,Spring,MATH1120,1,Final,60,53,-7
41A17,2016,Spring,MATH1120,1,test3,62,53,-9
13B13,2016,Fall,Math3650,0,Quiz6,75,53,-22
13B13,2016,Fall,Math3650,0,Test3,75,53,-22
23B11,2016,Fall,MAT192,0,Test2,77,53,-24
31B01,2016,Spring,MATH 2204,1,test1,78,53,-25
21C13,2016,Spring,192,0,test1,80,53,-27
13A23,2016,Fall,Math1113,1,Quiz1,81,53,-28
13A23,2016,Fall,Math1113,1,Quiz4,81,53,-28
13A23,2016,Fall,Math1113,1,Test1,81,53,-28
11A14,2016,Spring,Math 1111,1,Quiz4,42,54,12
21B8,2016,Spring,192,1,final,42,54,12
13A14,2016,Fall,Math1113,1,Quiz1,58,54,-4
13A14,2016,Fall,Math1113,1,Quiz4,58,54,-4
13A14,2016,Fall,Math1113,1,Test1,58,54,-4
13C15,2016,Fall,Math1111,0,Quiz4,60,54,-6
13C15,2016,Fall,Math1111,0,Quiz5,60,54,-6
13C15,2016,Fall,Math1111,0,Test2,60,54,-6
13C8,2016,Fall,Math1111,1,Quiz4,60,54,-6
13C8,2016,Fall,Math1111,1,Quiz5,60,54,-6
13C8,2016,Fall,Math1111,1,Test2,60,54,-6
13A9,2016,Fall,Math1113,1,Quiz1,65,54,-11
13A9,2016,Fall,Math1113,1,Quiz4,65,54,-11
13A9,2016,Fall,Math1113,1,Test1,65,54,-11
13B24,2016,Fall,Math3650,1,Quiz3,68,54,-14
11A5,2016,Spring,Math 1111,0,Quiz4,70,54,-16
13C5,2016,Fall,Math1111,1,Quiz6,70,54,-16
13C5,2016,Fall,Math1111,1,Quiz7,70,54,-16
13C5,2016,Fall,Math1111,1,Test3,70,54,-16
13C7,2016,Fall,Math1111,1,Quiz3,70,54,-16
13B24,2016,Fall,Math3650,1,Quiz7,75,54,-21
13A19,2016,Fall,Math1113,0,Quiz1,80,54,-26
13A19,2016,Fall,Math1113,0,Quiz4,80,54,-26
13A19,2016,Fall,Math1113,0,Test1,80,54,-26
11C1,2016,Spring,Math 2470,0,test2,60,54.5,-5.5
11A11,2016,Spring,Math 1111,0,Test2,40,55,15
13C9,2016,Fall,Math1111,1,Quiz4,50,55,5
13C9,2016,Fall,Math1111,1,Quiz5,50,55,5
13C9,2016,Fall,Math1111,1,Test2,50,55,5
21D12,2016,Spring,320,1,test2,50,55,5
13C2,2016,Fall,Math1111,1,Quiz4,60,55,-5
13C2,2016,Fall,Math1111,1,Quiz5,60,55,-5
13C2,2016,Fall,Math1111,1,Test2,60,55,-5
13C8,2016,Fall,Math1111,1,Quiz1,60,55,-5
13C8,2016,Fall,Math1111,1,Quiz2,60,55,-5
21B13,2016,Spring,192,1,test1,65,55,-10
13A8,2016,Fall,Math1113,0,Quiz8,69,55,-14
41A10,2016,Spring,MATH1101,0,test1,70,55,-15
13C6,2016,Fall,Math1111,1,Quiz6,70,55,-15
13C6,2016,Fall,Math1111,1,Quiz7,70,55,-15
13C6,2016,Fall,Math1111,1,Test3,70,55,-15
21B28,2016,Spring,192,1,test1,70,55,-15
31B25,2016,Spring,MATH 2204,0,test2,75,55,-20
13A6,2016,Fall,Math1113,1,Quiz6,75,55,-20
13A6,2016,Fall,Math1113,1,Test3,75,55,-20
13A10,2016,Fall,Math1113,1,Final,80,55,-25
13B22,2016,Fall,Math3650,1,Quiz6,80,55,-25
13B26,2016,Fall,Math3650,1,Test3,80,55,-25
21C21,2016,Spring,192,1,test3,80,55,-25
21B26,2016,Spring,192,0,final,85,55,-30
21B18,2016,Spring,192,1,test1,88,55,-33
41A32,2016,Spring,MATH1120,1,test2,90,55,-35
13B6,2016,Fall,Math3650,1,Quiz8,93,55,-38
41A20,2016,Spring,MATH1120,1,test3,41,56,15
13C9,2016,Fall,Math1111,1,Test1,45,56,11
13C3,2016,Fall,Math1111,1,Quiz4,50,56,6
13C3,2016,Fall,Math1111,1,Quiz5,50,56,6
13C3,2016,Fall,Math1111,1,Test2,50,56,6
11A13,2016,Spring,Math 1111,1,Final,50,56,6
13C8,2016,Fall,Math1111,1,Quiz3,60,56,-4
13C8,2016,Fall,Math1111,1,Test1,60,56,-4
13C9,2016,Fall,Math1111,1,Quiz1,60,56,-4
13C9,2016,Fall,Math1111,1,Quiz2,60,56,-4
21B3,2016,Spring,192,0,test3,70,56,-14
31A11,2016,Spring,MATH 2204,0,Final,70,56,-14
41A20,2016,Spring,MATH1120,1,test1,72,56,-16
21C15,2016,Spring,192,0,test2,73,56,-17
21D9,2016,Spring,320,1,final,74,56,-18
13B26,2016,Fall,Math3650,1,Quiz6,80,56,-24
13B27,2016,Fall,Math3650,1,Test3,80,56,-24
13B26,2016,Fall,Math3650,1,Quiz6,82,56,-26
13B6,2016,Fall,Math3650,1,Test3,82,56,-26
21B9,2016,Spring,192,1,test3,85,56,-29
21B20,2016,Spring,192,0,final,86,56,-30
13C14,2016,Fall,Math1111,0,Test1,100,56,-44
13C15,2016,Fall,Math1111,0,Quiz1,100,56,-44
13C15,2016,Fall,Math1111,0,Quiz2,100,56,-44
13C15,2016,Fall,Math1111,0,Quiz3,100,56,-44
31B17,2016,Spring,MATH 2204,1,quiz1,100,56,-44
41A03,2016,Spring,MATH1101,0,test2,35,57,22
41A19,2016,Spring,MATH1120,1,test3,54,57,3
13A18,2016,Fall,Math1113,1,Quiz3,59,57,-2
21D15,2016,Spring,320,1,test3,63,57,-6
13A17,2016,Fall,Math1113,1,Quiz7,67,57,-10
23B7,2016,Fall,MAT192,1,Final,72,57,-15
21D6,2016,Spring,320,1,test3,72,57,-15
21D5,2016,Spring,320,0,test2,85,57,-28
21D8,2016,Spring,320,1,final,86,57,-29
11A15,2016,Spring,Math 1111,1,Quiz4,91,57,-34
13A2,2016,Fall,Math1113,0,Quiz1,57,58,1
13A2,2016,Fall,Math1113,0,Quiz4,57,58,1
13A2,2016,Fall,Math1113,0,Test1,57,58,1
21D9,2016,Spring,320,1,test3,58,58,0
13C1,2016,Fall,Math1111,0,Quiz4,60,58,-2
13C1,2016,Fall,Math1111,0,Quiz5,60,58,-2
13C1,2016,Fall,Math1111,0,Test2,60,58,-2
13C16,2016,Fall,Math1111,0,Final,65,58,-7
13C16,2016,Fall,Math1111,0,Quiz8,65,58,-7
23A8,2016,Fall,MAT192,0,Test1,68,58,-10
41A35,2016,Spring,MATH1120,1,test1,68,58,-10
13A8,2016,Fall,Math1113,0,Quiz7,73,58,-15
23A18,2016,Fall,MAT192,0,Final,73,58,-15
13B6,2016,Fall,Math3650,1,Final,75,58,-17
21B2,2016,Spring,192,1,final,76,58,-18
21C2,2016,Spring,192,0,final,78,58,-20
13A11,2016,Fall,Math1113,0,Final,80,58,-22
21C25,2016,Spring,192,1,test2,80,58,-22
31B17,2016,Spring,MATH 2204,1,FINAL,82,58,-24
13A21,2016,Fall,Math1113,0,Quiz8,87,58,-29
21B3,2016,Spring,192,0,test1,59,59,0
41A12,2016,Spring,MATH1101,1,test1,60,59,-1
13A10,2016,Fall,Math1113,1,Quiz3,65,59,-6
21B28,2016,Spring,192,1,test2,68,59,-9
21C8,2016,Spring,192,0,test3,69,59,-10
23A20,2016,Fall,MAT192,1,Test2,70,59,-11
11C1,2016,Spring,Math 2470,0,test4,71,59,-12
13B2,2016,Fall,Math3650,1,Quiz8,72,59,-13
13B25,2016,Fall,Math3650,1,Test3,75,59,-16
13B6,2016,Fall,Math3650,1,Quiz6,75,59,-16
21C25,2016,Spring,192,1,test3,80,59,-21
23B16,2016,Fall,MAT192,0,Quiz6,40,60,20
23A15,2016,Fall,MAT192,0,Quiz6,50,60,10
23B17,2016,Fall,MAT192,0,Quiz8,50,60,10
13C9,2016,Fall,Math1111,1,Final,50,60,10
13C9,2016,Fall,Math1111,1,Quiz8,50,60,10
13C1,2016,Fall,Math1111,0,Quiz1,55,60,5
13C1,2016,Fall,Math1111,0,Quiz2,55,60,5
13C15,2016,Fall,Math1111,0,Test1,55,60,5
13C16,2016,Fall,Math1111,0,Quiz3,55,60,5
13A21,2016,Fall,Math1113,0,Quiz3,59,60,1
11A5,2016,Spring,Math 1111,0,Quiz1,60,60,0
21A1,2016,Spring,191,0,quiz5,60,60,0
21B14,2016,Spring,192,0,quiz3,60,60,0
21B19,2016,Spring,192,0,quiz3,60,60,0
21C8,2016,Spring,192,0,quiz6,60,60,0
21D5,2016,Spring,320,0,quiz4,60,60,0
31B02,2016,Spring,MATH 2204,0,FINAL,60,60,0
21B10,2016,Spring,192,1,quiz4,60,60,0
21B17,2016,Spring,192,1,quiz5,60,60,0
21B8,2016,Spring,192,1,quiz1,60,60,0
11C10,2016,Spring,Math 2470,1,test4,61,60,-1
41A19,2016,Spring,MATH1120,1,Final,62,60,-2
13A5,2016,Fall,Math1113,0,Quiz3,63,60,-3
11A6,2016,Spring,Math 1111,0,Quiz1,65,60,-5
13A9,2016,Fall,Math1113,1,Quiz2,65,60,-5
13A9,2016,Fall,Math1113,1,Quiz5,65,60,-5
13A9,2016,Fall,Math1113,1,Test2,65,60,-5
41A12,2016,Spring,MATH1101,1,test2,68,60,-8
11A7,2016,Spring,Math 1111,0,Final,70,60,-10
11A8,2016,Spring,Math 1111,0,final,70,60,-10
21B27,2016,Spring,192,0,test3,70,60,-10
13C8,2016,Fall,Math1111,1,Quiz6,70,60,-10
13C8,2016,Fall,Math1111,1,Quiz7,70,60,-10
13C8,2016,Fall,Math1111,1,Test3,70,60,-10
21A7,2016,Spring,191,1,quiz5,70,60,-10
21B10,2016,Spring,192,1,test3,70,60,-10
21C5,2016,Spring,192,0,test3,74,60,-14
21B5,2016,Spring,192,1,quiz2,75,60,-15
41A19,2016,Spring,MATH1120,1,test2,75,60,-15
13C16,2016,Fall,Math1111,0,Quiz6,80,60,-20
13C16,2016,Fall,Math1111,0,Quiz7,80,60,-20
13C16,2016,Fall,Math1111,0,Test3,80,60,-20
11A3,2016,Spring,Math 1111,0,Test2,80,60,-20
31A09,2016,Spring,MATH 2204,0,test1,80,60,-20
23A10,2016,Fall,MAT192,1,Quiz6,80,60,-20
23A7,2016,Fall,MAT192,1,Quiz6,80,60,-20
21B2,2016,Spring,192,1,quiz2,80,60,-20
21C11,2016,Spring,192,1,quiz3,80,60,-20
21D17,2016,Spring,320,1,quiz3,80,60,-20
31A16,2016,Spring,MATH 2204,1,test1,82,60,-22
13A21,2016,Fall,Math1113,0,Quiz2,85,60,-25
13A21,2016,Fall,Math1113,0,Quiz5,85,60,-25
13A21,2016,Fall,Math1113,0,Test2,85,60,-25
21D4,2016,Spring,320,0,test3,85,60,-25
21C26,2016,Spring,192,1,test1,85,60,-25
21B20,2016,Spring,192,0,quiz3,90,60,-30
21B26,2016,Spring,192,0,test3,90,60,-30
21C12,2016,Spring,192,0,quiz3,90,60,-30
31A09,2016,Spring,MATH 2204,0,quiz3,90,60,-30
21C17,2016,Spring,192,1,quiz6,90,60,-30
21B20,2016,Spring,192,0,test3,93,60,-33
21D10,2016,Spring,320,1,test3,93,60,-33
21A1,2016,Spring,191,0,quiz8,100,60,-40
21B1,2016,Spring,192,0,quiz3,100,60,-40
21C13,2016,Spring,192,0,quiz3,100,60,-40
21C22,2016,Spring,192,0,quiz3,100,60,-40
31A02,2016,Spring,MATH 2204,0,quiz1,100,60,-40
31B24,2016,Spring,MATH 2204,0,quiz2,100,60,-40
23A20,2016,Fall,MAT192,1,Quiz3,100,60,-40
23A20,2016,Fall,MAT192,1,Quiz8,100,60,-40
23B10,2016,Fall,MAT192,1,Quiz5,100,60,-40
21B16,2016,Spring,192,1,quiz1,100,60,-40
21B17,2016,Spring,192,1,quiz3,100,60,-40
21B9,2016,Spring,192,1,quiz3,100,60,-40
21C17,2016,Spring,192,1,quiz1,100,60,-40
21C3,2016,Spring,192,1,quiz3,100,60,-40
31A07,2016,Spring,MATH 2204,1,quiz1,100,60,-40
31B13,2016,Spring,MATH 2204,1,quiz2,100,60,-40
23B4,2016,Fall,MAT192,0,Test2,49,61,12
11A7,2016,Spring,Math 1111,0,Quiz1,50,61,11
31B02,2016,Spring,MATH 2204,0,test2,50,61,11
13A15,2016,Fall,Math1113,1,Quiz2,65,61,-4
13A15,2016,Fall,Math1113,1,Quiz5,65,61,-4
13A15,2016,Fall,Math1113,1,Test2,65,61,-4
13A7,2016,Fall,Math1113,0,Quiz1,69,61,-8
13A7,2016,Fall,Math1113,0,Quiz4,69,61,-8
13A7,2016,Fall,Math1113,0,Test1,69,61,-8
21B14,2016,Spring,192,0,test2,70,61,-9
23B8,2016,Fall,MAT192,1,Final,71,61,-10
21C9,2016,Spring,192,1,final,73,61,-12
41A10,2016,Spring,MATH1101,0,test2,75,61,-14
21B4,2016,Spring,192,1,final,78,61,-17
11A4,2016,Spring,Math 1111,0,Test2,80,61,-19
21B9,2016,Spring,192,1,test1,80,61,-19
21C4,2016,Spring,192,1,test1,80,61,-19
21D5,2016,Spring,320,0,final,81,61,-20
13B26,2016,Fall,Math3650,1,Quiz1,82,61,-21
13B6,2016,Fall,Math3650,1,Quiz4,82,61,-21
13B7,2016,Fall,Math3650,1,Test1,82,61,-21
31B16,2016,Spring,MATH 2204,0,test2,85,61,-24
13A22,2016,Fall,Math1113,0,Quiz8,87,61,-26
21B21,2016,Spring,192,1,test3,88,61,-27
23A15,2016,Fall,MAT192,0,Test1,90,61,-29
13B17,2016,Fall,Math3650,0,Quiz8,92,61,-31
13A24,2016,Fall,Math1113,0,Quiz7,42,62,20
41A27,2016,Spring,MATH1120,1,test1,56,62,6
31B05,2016,Spring,MATH 2204,0,test2,60,62,2
13C2,2016,Fall,Math1111,1,Quiz3,70,62,-8
13C9,2016,Fall,Math1111,1,Quiz6,70,62,-8
13C9,2016,Fall,Math1111,1,Quiz7,70,62,-8
13C9,2016,Fall,Math1111,1,Test3,70,62,-8
31A07,2016,Spring,MATH 2204,1,test1,70,62,-8
13B17,2016,Fall,Math3650,0,Quiz7,73,62,-11
13A12,2016,Fall,Math1113,0,Final,80,62,-18
13C10,2016,Fall,Math1111,0,Quiz1,80,62,-18
13C10,2016,Fall,Math1111,0,Quiz2,80,62,-18
13C10,2016,Fall,Math1111,0,Quiz3,80,62,-18
13C10,2016,Fall,Math1111,0,Test1,80,62,-18
31B01,2016,Spring,MATH 2204,1,test2,80,62,-18
31A02,2016,Spring,MATH 2204,0,test1,88,62,-26
21B25,2016,Spring,192,1,test1,88,62,-26
11A5,2016,Spring,Math 1111,0,Test2,90,62,-28
21D8,2016,Spring,320,1,test3,90,62,-28
41A36,2016,Spring,MATH3317,1,test2,38,63,25
31A14,2016,Spring,MATH 2204,1,test1,60,63,3
13C10,2016,Fall,Math1111,0,Quiz4,64,63,-1
13C10,2016,Fall,Math1111,0,Quiz5,64,63,-1
13C10,2016,Fall,Math1111,0,Test2,64,63,-1
41A03,2016,Spring,MATH1101,0,Final,64,63,-1
13A17,2016,Fall,Math1113,1,Quiz6,70,63,-7
13A17,2016,Fall,Math1113,1,Test3,70,63,-7
23B2,2016,Fall,MAT192,1,Test3,70,63,-7
23B5,2016,Fall,MAT192,1,Test3,70,63,-7
13A18,2016,Fall,Math1113,1,Quiz1,73,63,-10
13A18,2016,Fall,Math1113,1,Quiz4,73,63,-10
13A18,2016,Fall,Math1113,1,Test1,73,63,-10
21C13,2016,Spring,192,0,test2,76,63,-13
21D3,2016,Spring,320,0,test3,77,63,-14
13C11,2016,Fall,Math1111,0,Quiz1,80,63,-17
13C11,2016,Fall,Math1111,0,Quiz2,80,63,-17
13C11,2016,Fall,Math1111,0,Quiz3,80,63,-17
13C11,2016,Fall,Math1111,0,Test1,80,63,-17
13A13,2016,Fall,Math1113,0,Final,82,63,-19
31A04,2016,Spring,MATH 2204,0,test1,83,63,-20
41A27,2016,Spring,MATH1120,1,test2,83,63,-20
31C01,2016,Spring,MATH 2222,1,test1,88,63,-25
11C17,2016,Spring,Math 2470,1,test4,90,63,-27
21B16,2016,Spring,192,1,test1,92,63,-29
21C18,2016,Spring,192,1,final,95,63,-32
21C20,2016,Spring,192,1,test3,100,63,-37
13C3,2016,Fall,Math1111,1,Quiz6,58,64,6
13C3,2016,Fall,Math1111,1,Quiz7,58,64,6
13C3,2016,Fall,Math1111,1,Test3,58,64,6
13C1,2016,Fall,Math1111,0,Final,60,64,4
13C1,2016,Fall,Math1111,0,Quiz8,60,64,4
13A15,2016,Fall,Math1113,1,Quiz3,69,64,-5
31A19,2016,Spring,MATH 2204,0,Final,70,64,-6
41A10,2016,Spring,MATH1101,0,Final,71,64,-7
13A9,2016,Fall,Math1113,1,Quiz8,74,64,-10
13B22,2016,Fall,Math3650,1,Final,77,64,-13
23B17,2016,Fall,MAT192,0,Final,78,64,-14
13C16,2016,Fall,Math1111,0,Test1,80,64,-16
23A5,2016,Fall,MAT192,0,Test1,80,64,-16
31B18,2016,Spring,MATH 2204,0,test2,80,64,-16
13C2,2016,Fall,Math1111,1,Quiz1,80,64,-16
13C2,2016,Fall,Math1111,1,Quiz2,80,64,-16
13C3,2016,Fall,Math1111,1,Quiz3,80,64,-16
41A16,2016,Spring,MATH1120,1,test2,80,64,-16
13B21,2016,Fall,Math3650,1,Quiz4,81,64,-17
13B21,2016,Fall,Math3650,1,Test1,81,64,-17
13B7,2016,Fall,Math3650,1,Quiz1,81,64,-17
13B9,2016,Fall,Math3650,1,Quiz3,81,64,-17
13A11,2016,Fall,Math1113,0,Quiz7,84,64,-20
21D9,2016,Spring,320,1,test2,84,64,-20
13A21,2016,Fall,Math1113,0,Quiz6,85,64,-21
13A21,2016,Fall,Math1113,0,Test3,85,64,-21
41A01,2016,Spring,MATH1101,1,test1,85,64,-21
41A18,2016,Spring,MATH1120,1,test2,85,64,-21
13A20,2016,Fall,Math1113,0,Quiz1,86,64,-22
13A20,2016,Fall,Math1113,0,Quiz4,86,64,-22
13A20,2016,Fall,Math1113,0,Test1,86,64,-22
13A7,2016,Fall,Math1113,0,Quiz2,87,64,-23
13A7,2016,Fall,Math1113,0,Quiz5,87,64,-23
13A7,2016,Fall,Math1113,0,Test2,87,64,-23
13B24,2016,Fall,Math3650,1,Quiz8,88,64,-24
13B22,2016,Fall,Math3650,1,Quiz8,89,64,-25
21D10,2016,Spring,320,1,test1,90,64,-26
21B24,2016,Spring,192,1,test3,100,64,-36
11C12,2016,Spring,Math 2470,1,test2,60,64.5,4.5
23A20,2016,Fall,MAT192,1,Quiz6,50,65,15
21B7,2016,Spring,192,1,quiz6,50,65,15
21B3,2016,Spring,192,0,quiz6,70,65,-5
41A21,2016,Spring,MATH1120,0,test1,70,65,-5
13C3,2016,Fall,Math1111,1,Final,70,65,-5
13C3,2016,Fall,Math1111,1,Quiz8,70,65,-5
23B14,2016,Fall,MAT192,1,Quiz6,70,65,-5
23A20,2016,Fall,MAT192,1,Final,71,65,-6
23B2,2016,Fall,MAT192,1,Test2,72,65,-7
13B1,2016,Fall,Math3650,0,Quiz1,75,65,-10
13B13,2016,Fall,Math3650,0,Quiz4,75,65,-10
13B14,2016,Fall,Math3650,0,Test1,75,65,-10
21C15,2016,Spring,192,0,final,75,65,-10
21B6,2016,Spring,192,1,test3,75,65,-10
41A16,2016,Spring,MATH1120,1,test1,75,65,-10
13A22,2016,Fall,Math1113,0,Quiz2,78,65,-13
13A22,2016,Fall,Math1113,0,Quiz5,78,65,-13
13A22,2016,Fall,Math1113,0,Test2,78,65,-13
21D4,2016,Spring,320,0,test1,80,65,-15
13A9,2016,Fall,Math1113,1,Quiz6,80,65,-15
13A9,2016,Fall,Math1113,1,Test3,80,65,-15
21A3,2016,Spring,191,0,final,83,65,-18
31B03,2016,Spring,MATH 2204,0,test2,85,65,-20
31B20,2016,Spring,MATH 2204,0,test2,85,65,-20
21C3,2016,Spring,192,1,test3,88,65,-23
23B4,2016,Fall,MAT192,0,Quiz4,90,65,-25
21B22,2016,Spring,192,0,test3,90,65,-25
31A10,2016,Spring,MATH 2204,0,test1,90,65,-25
31B24,2016,Spring,MATH 2204,0,test2,90,65,-25
23A10,2016,Fall,MAT192,1,Quiz8,90,65,-25
31C01,2016,Spring,MATH 2222,1,FINAL,91,65,-26
23A7,2016,Fall,MAT192,1,Quiz3,100,65,-35
11C2,2016,Spring,Math 2470,0,test2,65,65.5,0.5
23B16,2016,Fall,MAT192,0,Final,47,66,19
11C13,2016,Spring,Math 2470,1,test4,58,66,8
13C1,2016,Fall,Math1111,0,Quiz6,66,66,0
13C1,2016,Fall,Math1111,0,Quiz7,66,66,0
13C1,2016,Fall,Math1111,0,Test3,66,66,0
31B05,2016,Spring,MATH 2204,0,FINAL,70,66,-4
31B14,2016,Spring,MATH 2204,0,test2,70,66,-4
41A12,2016,Spring,MATH1101,1,Final,72,66,-6
23B11,2016,Fall,MAT192,0,Final,73,66,-7
13A1,2016,Fall,Math1113,1,Quiz7,75,66,-9
31B06,2016,Spring,MATH 2204,1,test1,80,66,-14
13A8,2016,Fall,Math1113,0,Quiz1,82,66,-16
13A8,2016,Fall,Math1113,0,Quiz4,82,66,-16
13A8,2016,Fall,Math1113,0,Test1,82,66,-16
13B24,2016,Fall,Math3650,1,Quiz5,83,66,-17
13B26,2016,Fall,Math3650,1,Quiz2,83,66,-17
13B26,2016,Fall,Math3650,1,Test2,83,66,-17
13A22,2016,Fall,Math1113,0,Quiz6,85,66,-19
13A22,2016,Fall,Math1113,0,Test3,85,66,-19
13A24,2016,Fall,Math1113,0,Quiz8,85,66,-19
31B11,2016,Spring,MATH 2204,1,test2,85,66,-19
13A14,2016,Fall,Math1113,1,Final,90,66,-24
13B25,2016,Fall,Math3650,1,Quiz6,90,66,-24
13B26,2016,Fall,Math3650,1,Test3,90,66,-24
11A8,2016,Spring,Math 1111,0,Quiz1,50,67,17
13C10,2016,Fall,Math1111,0,Final,53,67,14
13C10,2016,Fall,Math1111,0,Quiz8,53,67,14
21D6,2016,Spring,320,1,final,58,67,9
21C6,2016,Spring,192,0,test3,60,67,7
13A1,2016,Fall,Math1113,1,Quiz8,61,67,6
23B16,2016,Fall,MAT192,0,Test2,63,67,4
21C8,2016,Spring,192,0,test2,67,67,0
31B05,2016,Spring,MATH 2204,0,quiz1,70,67,-3
31B10,2016,Spring,MATH 2204,0,test2,70,67,-3
13B26,2016,Fall,Math3650,1,Quiz6,73,67,-6
13B4,2016,Fall,Math3650,1,Test3,73,67,-6
11C5,2016,Spring,Math 2470,0,test4,78,67,-11
31A07,2016,Spring,MATH 2204,1,quiz2,80,67,-13
21C1,2016,Spring,192,1,test1,81,67,-14
13C2,2016,Fall,Math1111,1,Test1,82,67,-15
21C23,2016,Spring,192,0,test3,83,67,-16
31B17,2016,Spring,MATH 2204,1,test2,83,67,-16
23B7,2016,Fall,MAT192,1,Test3,85,67,-18
41A35,2016,Spring,MATH1120,1,Final,88,67,-21
13C11,2016,Fall,Math1111,0,Quiz4,90,67,-23
13C11,2016,Fall,Math1111,0,Quiz5,90,67,-23
13C11,2016,Fall,Math1111,0,Test2,90,67,-23
31B14,2016,Spring,MATH 2204,0,quiz1,90,67,-23
11C6,2016,Spring,Math 2470,0,test2,95,67.5,-27.5
23B14,2016,Fall,MAT192,1,Final,55,68,13
23B14,2016,Fall,MAT192,1,Test1,57,68,11
13C12,2016,Fall,Math1111,0,Quiz4,60,68,8
13C12,2016,Fall,Math1111,0,Quiz5,60,68,8
13C12,2016,Fall,Math1111,0,Test2,60,68,8
21D5,2016,Spring,320,0,test3,66,68,2
13B27,2016,Fall,Math3650,1,Quiz7,73,68,-5
21D4,2016,Spring,320,0,final,74,68,-6
13C3,2016,Fall,Math1111,1,Test1,75,68,-7
13A21,2016,Fall,Math1113,0,Quiz1,80,68,-12
13A21,2016,Fall,Math1113,0,Quiz4,80,68,-12
13A21,2016,Fall,Math1113,0,Test1,80,68,-12
11A6,2016,Spring,Math 1111,0,Test2,80,68,-12
11A12,2016,Spring,Math 1111,1,Test2,80,68,-12
21D3,2016,Spring,320,0,final,82,68,-14
23A5,2016,Fall,MAT192,0,Test3,85,68,-17
13A10,2016,Fall,Math1113,1,Quiz7,85,68,-17
21B11,2016,Spring,192,1,test1,85,68,-17
13A15,2016,Fall,Math1113,1,Final,94,68,-26
21C9,2016,Spring,192,1,test1,94,68,-26
21B10,2016,Spring,192,1,test1,100,68,-32
21B2,2016,Spring,192,1,test3,100,68,-32
23B14,2016,Fall,MAT192,1,Test2,70,69,-1
23A15,2016,Fall,MAT192,0,Test3,74,69,-5
13B2,2016,Fall,Math3650,1,Test3,74,69,-5
13B6,2016,Fall,Math3650,1,Quiz6,74,69,-5
21B17,2016,Spring,192,1,final,74,69,-5
21A3,2016,Spring,191,0,test2,76,69,-7
13A4,2016,Fall,Math1113,0,Quiz7,77,69,-8
13A11,2016,Fall,Math1113,0,Quiz8,79,69,-10
13A1,2016,Fall,Math1113,1,Quiz6,80,69,-11
13A1,2016,Fall,Math1113,1,Test3,80,69,-11
13A16,2016,Fall,Math1113,1,Final,80,69,-11
31B13,2016,Spring,MATH 2204,1,test2,80,69,-11
13B6,2016,Fall,Math3650,1,Quiz7,81,69,-12
21C10,2016,Spring,192,0,test2,85,69,-16
21D13,2016,Spring,320,1,test2,85,69,-16
31B21,2016,Spring,MATH 2204,1,test2,85,69,-16
21B22,2016,Spring,192,0,test1,87,69,-18
23A10,2016,Fall,MAT192,1,Test2,90,69,-21
23A12,2016,Fall,MAT192,0,Quiz6,50,70,20
23A5,2016,Fall,MAT192,0,Quiz8,50,70,20
23B4,2016,Fall,MAT192,0,Quiz6,50,70,20
11A9,2016,Spring,Math 1111,0,final,50,70,20
21B14,2016,Spring,192,0,quiz5,50,70,20
21D3,2016,Spring,320,0,quiz4,50,70,20
23A7,2016,Fall,MAT192,1,Quiz2,50,70,20
23B2,2016,Fall,MAT192,1,Quiz6,50,70,20
21B16,2016,Spring,192,1,quiz3,50,70,20
21B25,2016,Spring,192,1,test2,50,70,20
21B7,2016,Spring,192,1,quiz1,50,70,20
11C8,2016,Spring,Math 2470,1,test4,56,70,14
11A14,2016,Spring,Math 1111,1,Final,58,70,12
23A12,2016,Fall,MAT192,0,Quiz2,60,70,10
21B14,2016,Spring,192,0,quiz1,60,70,10
21C2,2016,Spring,192,0,quiz5,60,70,10
21D5,2016,Spring,320,0,quiz6,60,70,10
13A16,2016,Fall,Math1113,1,Quiz2,60,70,10
13A16,2016,Fall,Math1113,1,Quiz5,60,70,10
13A16,2016,Fall,Math1113,1,Test2,60,70,10
21D6,2016,Spring,320,1,quiz6,60,70,10
11C2,2016,Spring,Math 2470,0,test4,61,70,9
13A8,2016,Fall,Math1113,0,Quiz2,62,70,8
13A8,2016,Fall,Math1113,0,Quiz5,62,70,8
13A8,2016,Fall,Math1113,0,Test2,62,70,8
41A22,2016,Spring,MATH1120,1,test1,68,70,2
11A11,2016,Spring,Math 1111,0,Quiz2,69,70,1
13B14,2016,Fall,Math3650,0,Final,70,70,0
23B11,2016,Fall,MAT192,0,Quiz6,70,70,0
21C22,2016,Spring,192,0,final,70,70,0
21D3,2016,Spring,320,0,quiz6,70,70,0
11C15,2016,Spring,Math 2470,1,final,70,70,0
11C19,2016,Spring,Math 2470,1,test2,70,70,0
21B21,2016,Spring,192,1,quiz3,70,70,0
21C26,2016,Spring,192,1,quiz1,70,70,0
21D11,2016,Spring,320,1,quiz6,70,70,0
21D7,2016,Spring,320,1,quiz3,70,70,0
31B11,2016,Spring,MATH 2204,1,quiz2,70,70,0
23B16,2016,Fall,MAT192,0,Test1,72,70,-2
13B14,2016,Fall,Math3650,0,Quiz3,75,70,-5
23A8,2016,Fall,MAT192,0,Test3,75,70,-5
41A13,2016,Spring,MATH1120,1,test1,76,70,-6
21C20,2016,Spring,192,1,final,77,70,-7
11A15,2016,Spring,Math 1111,1,final,78,70,-8
13A1,2016,Fall,Math1113,1,Quiz1,79,70,-9
13A1,2016,Fall,Math1113,1,Quiz4,79,70,-9
13A1,2016,Fall,Math1113,1,Test1,79,70,-9
21C9,2016,Spring,192,1,test3,79,70,-9
21B27,2016,Spring,192,0,quiz3,80,70,-10
31B05,2016,Spring,MATH 2204,0,quiz2,80,70,-10
31B18,2016,Spring,MATH 2204,0,test1,80,70,-10
13B6,2016,Fall,Math3650,1,Quiz7,80,70,-10
21A5,2016,Spring,191,1,quiz7,80,70,-10
21B8,2016,Spring,192,1,quiz6,80,70,-10
21C3,2016,Spring,192,1,quiz1,80,70,-10
21C4,2016,Spring,192,1,quiz4,80,70,-10
21D6,2016,Spring,320,1,quiz4,80,70,-10
21D8,2016,Spring,320,1,quiz4,80,70,-10
31A14,2016,Spring,MATH 2204,1,quiz3,80,70,-10
13A24,2016,Fall,Math1113,0,Quiz2,82,70,-12
13A24,2016,Fall,Math1113,0,Quiz5,82,70,-12
13A24,2016,Fall,Math1113,0,Test2,82,70,-12
13A12,2016,Fall,Math1113,0,Quiz8,83,70,-13
13A7,2016,Fall,Math1113,0,Quiz3,83,70,-13
13A16,2016,Fall,Math1113,1,Quiz3,83,70,-13
11A16,2016,Spring,Math 1111,1,final,83,70,-13
31C03,2016,Spring,MATH 2222,1,test1,84,70,-14
21D13,2016,Spring,320,1,final,86,70,-16
41A13,2016,Spring,MATH1120,1,test3,87,70,-17
21C12,2016,Spring,192,0,quiz6,90,70,-20
21D4,2016,Spring,320,0,quiz6,90,70,-20
21B13,2016,Spring,192,1,quiz5,90,70,-20
21B18,2016,Spring,192,1,test3,90,70,-20
21B6,2016,Spring,192,1,quiz6,90,70,-20
21C3,2016,Spring,192,1,quiz2,90,70,-20
21C9,2016,Spring,192,1,quiz1,90,70,-20
21B19,2016,Spring,192,0,test2,92,70,-22
21C4,2016,Spring,192,1,test3,94,70,-24
23A18,2016,Fall,MAT192,0,Quiz2,95,70,-25
31B16,2016,Spring,MATH 2204,0,quiz2,95,70,-25
21C7,2016,Spring,192,1,test1,98,70,-28
23A14,2016,Fall,MAT192,0,Quiz4,100,70,-30
23B13,2016,Fall,MAT192,0,Quiz4,100,70,-30
21A1,2016,Spring,191,0,quiz3,100,70,-30
21A2,2016,Spring,191,0,quiz5,100,70,-30
21A6,2016,Spring,191,0,quiz5,100,70,-30
21B22,2016,Spring,192,0,quiz3,100,70,-30
21C5,2016,Spring,192,0,quiz3,100,70,-30
31A04,2016,Spring,MATH 2204,0,quiz1,100,70,-30
31A19,2016,Spring,MATH 2204,0,quiz1,100,70,-30
31A19,2016,Spring,MATH 2204,0,quiz3,100,70,-30
31B18,2016,Spring,MATH 2204,0,quiz2,100,70,-30
23A10,2016,Fall,MAT192,1,Quiz4,100,70,-30
23A19,2016,Fall,MAT192,1,Quiz4,100,70,-30
23A3,2016,Fall,MAT192,1,Quiz4,100,70,-30
23B2,2016,Fall,MAT192,1,Quiz8,100,70,-30
23B8,2016,Fall,MAT192,1,Quiz3,100,70,-30
21A5,2016,Spring,191,1,quiz5,100,70,-30
21B18,2016,Spring,192,1,quiz6,100,70,-30
21B2,2016,Spring,192,1,quiz6,100,70,-30
21B25,2016,Spring,192,1,quiz1,100,70,-30
21C20,2016,Spring,192,1,quiz2,100,70,-30
21C4,2016,Spring,192,1,quiz1,100,70,-30
31A15,2016,Spring,MATH 2204,1,quiz3,100,70,-30
31B22,2016,Spring,MATH 2204,1,quiz2,100,70,-30
11A17,2016,Spring,Math 1111,1,Final,53,71,18
13B2,2016,Fall,Math3650,1,Quiz6,68,71,3
13B22,2016,Fall,Math3650,1,Test3,68,71,3
13B8,2016,Fall,Math3650,1,Quiz3,71,71,0
11C19,2016,Spring,Math 2470,1,test3,71,71,0
13B22,2016,Fall,Math3650,1,Test1,73,71,-2
13B4,2016,Fall,Math3650,1,Quiz1,73,71,-2
13B9,2016,Fall,Math3650,1,Quiz4,73,71,-2
13B2,2016,Fall,Math3650,1,Test1,74,71,-3
13B27,2016,Fall,Math3650,1,Quiz1,74,71,-3
13B7,2016,Fall,Math3650,1,Quiz4,74,71,-3
21D15,2016,Spring,320,1,final,74,71,-3
13C13,2016,Fall,Math1111,0,Quiz4,76,71,-5
13C13,2016,Fall,Math1111,0,Quiz5,76,71,-5
13C13,2016,Fall,Math1111,0,Test2,76,71,-5
21D11,2016,Spring,320,1,final,76,71,-5
21B27,2016,Spring,192,0,test2,77,71,-6
13A1,2016,Fall,Math1113,1,Quiz2,77,71,-6
13A1,2016,Fall,Math1113,1,Quiz5,77,71,-6
13A1,2016,Fall,Math1113,1,Test2,77,71,-6
13C10,2016,Fall,Math1111,0,Quiz6,80,71,-9
13C10,2016,Fall,Math1111,0,Quiz7,80,71,-9
13C10,2016,Fall,Math1111,0,Test3,80,71,-9
13D1,2016,Fall,Math1111,0,Quiz4,80,71,-9
13D1,2016,Fall,Math1111,0,Quiz5,80,71,-9
13D1,2016,Fall,Math1111,0,Test2,80,71,-9
11A5,2016,Spring,Math 1111,0,Quiz2,80,71,-9
31B13,2016,Spring,MATH 2204,1,test1,80,71,-9
11A2,2016,Spring,Math 1111,0,final,82,71,-11
13B21,2016,Fall,Math3650,1,Quiz7,86,71,-15
31B15,2016,Spring,MATH 2204,1,test2,95,71,-24
31A11,2016,Spring,MATH 2204,0,test1,100,71,-29
21B24,2016,Spring,192,1,test2,100,71,-29
13C11,2016,Fall,Math1111,0,Final,60,72,12
13C11,2016,Fall,Math1111,0,Quiz8,60,72,12
13A17,2016,Fall,Math1113,1,Quiz3,64,72,8
31B04,2016,Spring,MATH 2204,1,FINAL,70,72,2
13B27,2016,Fall,Math3650,1,Quiz8,72,72,0
23A18,2016,Fall,MAT192,0,Test2,73,72,-1
41A05,2016,Spring,MATH1101,0,test2,73,72,-1
11A17,2016,Spring,Math 1111,1,Quiz5,73,72,-1
21B3,2016,Spring,192,0,test2,75,72,-3
13A8,2016,Fall,Math1113,0,Quiz3,80,72,-8
11A13,2016,Spring,Math 1111,1,Test2,80,72,-8
13B21,2016,Fall,Math3650,1,Quiz3,82,72,-10
13A11,2016,Fall,Math1113,0,Quiz1,83,72,-11
13A11,2016,Fall,Math1113,0,Quiz4,83,72,-11
13A11,2016,Fall,Math1113,0,Test1,83,72,-11
13C12,2016,Fall,Math1111,0,Quiz1,84,72,-12
13C12,2016,Fall,Math1111,0,Quiz2,84,72,-12
13C12,2016,Fall,Math1111,0,Quiz3,84,72,-12
13C12,2016,Fall,Math1111,0,Test1,84,72,-12
13C3,2016,Fall,Math1111,1,Quiz1,84,72,-12
13C3,2016,Fall,Math1111,1,Quiz2,84,72,-12
13C4,2016,Fall,Math1111,1,Quiz3,84,72,-12
13C4,2016,Fall,Math1111,1,Test1,84,72,-12
23B4,2016,Fall,MAT192,0,Test3,85,72,-13
21C13,2016,Spring,192,0,test3,85,72,-13
41A17,2016,Spring,MATH1120,1,test1,85,72,-13
13A17,2016,Fall,Math1113,1,Final,95,72,-23
21C11,2016,Spring,192,1,test3,100,72,-28
13C4,2016,Fall,Math1111,1,Quiz1,50,73,23
13C4,2016,Fall,Math1111,1,Quiz2,50,73,23
13D6,2016,Fall,Math1111,1,Quiz3,50,73,23
13D7,2016,Fall,Math1111,1,Test1,50,73,23
13C11,2016,Fall,Math1111,0,Quiz6,60,73,13
13C11,2016,Fall,Math1111,0,Quiz7,60,73,13
13C11,2016,Fall,Math1111,0,Test3,60,73,13
13C13,2016,Fall,Math1111,0,Quiz3,60,73,13
23A18,2016,Fall,MAT192,0,Test3,65,73,8
13B25,2016,Fall,Math3650,1,Quiz3,68,73,5
13A10,2016,Fall,Math1113,1,Quiz6,70,73,3
13A10,2016,Fall,Math1113,1,Test3,70,73,3
13A23,2016,Fall,Math1113,1,Quiz3,70,73,3
23B4,2016,Fall,MAT192,0,Final,72,73,1
21B5,2016,Spring,192,1,test2,73,73,0
13B26,2016,Fall,Math3650,1,Quiz3,75,73,-2
23B7,2016,Fall,MAT192,1,Test2,75,73,-2
41A14,2016,Spring,MATH1120,1,test3,76,73,-3
13C12,2016,Fall,Math1111,0,Final,77,73,-4
13C12,2016,Fall,Math1111,0,Quiz8,77,73,-4
13A11,2016,Fall,Math1113,0,Quiz6,79,73,-6
13A11,2016,Fall,Math1113,0,Test3,79,73,-6
13A5,2016,Fall,Math1113,0,Quiz7,81,73,-8
11A8,2016,Spring,Math 1111,0,Quiz5,83,73,-10
21B1,2016,Spring,192,0,test3,83,73,-10
41A35,2016,Spring,MATH1120,1,test3,85,73,-12
11A3,2016,Spring,Math 1111,0,Final,86,73,-13
13A18,2016,Fall,Math1113,1,Final,87,73,-14
21C15,2016,Spring,192,0,test1,89,73,-16
21B18,2016,Spring,192,1,test2,90,73,-17
13C4,2016,Fall,Math1111,1,Final,40,74,34
13C4,2016,Fall,Math1111,1,Quiz8,40,74,34
13D17,2016,Fall,Math1111,0,Test1,55,74,19
41A21,2016,Spring,MATH1120,0,test2,65,74,9
41A21,2016,Spring,MATH1120,0,test3,68,74,6
41A19,2016,Spring,MATH1120,1,test1,73,74,1
31A12,2016,Spring,MATH 2204,0,Final,75,74,-1
21C9,2016,Spring,192,1,test2,75,74,-1
21D7,2016,Spring,320,1,final,76,74,-2
13A1,2016,Fall,Math1113,1,Quiz3,78,74,-4
13A4,2016,Fall,Math1113,0,Quiz8,79,74,-5
11A1,2016,Spring,Math 1111,0,Test1,80,74,-6
13A24,2016,Fall,Math1113,0,Quiz6,83,74,-9
13A24,2016,Fall,Math1113,0,Test3,83,74,-9
21C11,2016,Spring,192,1,final,88,74,-14
21A2,2016,Spring,191,0,test2,90,74,-16
21C20,2016,Spring,192,1,test2,90,74,-16
21B12,2016,Spring,192,1,test1,95,74,-21
13D17,2016,Fall,Math1111,0,Quiz1,50,75,25
13D17,2016,Fall,Math1111,0,Quiz2,50,75,25
13D18,2016,Fall,Math1111,0,Quiz4,50,75,25
13D18,2016,Fall,Math1111,0,Quiz5,50,75,25
13D18,2016,Fall,Math1111,0,Test2,50,75,25
23B4,2016,Fall,MAT192,0,Quiz8,50,75,25
23B2,2016,Fall,MAT192,1,Quiz7,50,75,25
21B16,2016,Spring,192,1,quiz6,50,75,25
21C25,2016,Spring,192,1,final,59,75,16
13A18,2016,Fall,Math1113,1,Quiz8,67,75,8
21B3,2016,Spring,192,0,quiz2,70,75,5
13B26,2016,Fall,Math3650,1,Quiz7,72,75,3
13C5,2016,Fall,Math1111,1,Final,72,75,3
13C5,2016,Fall,Math1111,1,Quiz8,72,75,3
11A4,2016,Spring,Math 1111,0,final,73,75,2
21B22,2016,Spring,192,0,final,74,75,1
11A5,2016,Spring,Math 1111,0,final,75,75,0
13B26,2016,Fall,Math3650,1,Quiz5,75,75,0
13B26,2016,Fall,Math3650,1,Test2,75,75,0
13B27,2016,Fall,Math3650,1,Quiz2,75,75,0
23B2,2016,Fall,MAT192,1,Final,75,75,0
13A18,2016,Fall,Math1113,1,Quiz7,76,75,-1
21C22,2016,Spring,192,0,test3,77,75,-2
13D1,2016,Fall,Math1111,0,Quiz1,78,75,-3
13D1,2016,Fall,Math1111,0,Quiz2,78,75,-3
13D16,2016,Fall,Math1111,0,Quiz3,78,75,-3
13D18,2016,Fall,Math1111,0,Test1,78,75,-3
21D3,2016,Spring,320,0,test2,79,75,-4
23B7,2016,Fall,MAT192,1,Quiz6,80,75,-5
11A16,2016,Spring,Math 1111,1,Quiz2,80,75,-5
11A15,2016,Spring,Math 1111,1,Test1,80,75,-5
41A06,2016,Spring,MATH1101,0,test2,81,75,-6
21D10,2016,Spring,320,1,final,83,75,-8
31C04,2016,Spring,MATH 2222,0,FINAL,84,75,-9
13B27,2016,Fall,Math3650,1,Quiz3,84,75,-9
21B27,2016,Spring,192,0,final,85,75,-10
21C4,2016,Spring,192,1,final,85,75,-10
21D11,2016,Spring,320,1,test3,85,75,-10
21D10,2016,Spring,320,1,test2,89,75,-14
21B19,2016,Spring,192,0,quiz2,90,75,-15
41A09,2016,Spring,MATH1101,1,Final,90,75,-15
21B29,2016,Spring,192,1,final,93,75,-18
23A2,2016,Fall,MAT192,1,Test2,98,75,-23
21B4,2016,Spring,192,1,quiz6,100,75,-25
13D17,2016,Fall,Math1111,0,Quiz3,50,76,26
13D18,2016,Fall,Math1111,0,Quiz1,50,76,26
13D18,2016,Fall,Math1111,0,Quiz2,50,76,26
13D19,2016,Fall,Math1111,0,Test1,50,76,26
11A9,2016,Spring,Math 1111,0,Quiz5,70,76,6
21C24,2016,Spring,192,0,test3,75,76,1
21D8,2016,Spring,320,1,test1,76,76,0
11A10,2016,Spring,Math 1111,0,Quiz5,78,76,-2
31A13,2016,Spring,MATH 2204,0,Final,80,76,-4
31B06,2016,Spring,MATH 2204,1,test2,80,76,-4
21C5,2016,Spring,192,0,final,81,76,-5
13B21,2016,Fall,Math3650,1,Quiz8,81,76,-5
13A11,2016,Fall,Math1113,0,Quiz3,82,76,-6
11C1,2016,Spring,Math 2470,0,final,82,76,-6
13B14,2016,Fall,Math3650,0,Quiz6,84,76,-8
13B17,2016,Fall,Math3650,0,Test3,84,76,-8
11C2,2016,Spring,Math 2470,0,final,84,76,-8
11C9,2016,Spring,Math 2470,1,test4,84,76,-8
41A16,2016,Spring,MATH1120,1,test3,84,76,-8
13B6,2016,Fall,Math3650,1,Quiz7,85,76,-9
21B16,2016,Spring,192,1,test3,85,76,-9
13A12,2016,Fall,Math1113,0,Quiz3,87,76,-11
21C10,2016,Spring,192,0,final,88,76,-12
21B19,2016,Spring,192,0,test3,90,76,-14
31B24,2016,Spring,MATH 2204,0,FINAL,90,76,-14
13B26,2016,Fall,Math3650,1,Quiz1,90,76,-14
13B4,2016,Fall,Math3650,1,Quiz4,90,76,-14
13B4,2016,Fall,Math3650,1,Test1,90,76,-14
21D13,2016,Spring,320,1,test3,91,76,-15
21B10,2016,Spring,192,1,final,94,76,-18
41A26,2016,Spring,MATH1120,1,test1,95,76,-19
21B19,2016,Spring,192,0,final,97,76,-21
21B28,2016,Spring,192,1,test3,100,76,-24
13C12,2016,Fall,Math1111,0,Quiz6,50,77,27
13C12,2016,Fall,Math1111,0,Quiz7,50,77,27
13C12,2016,Fall,Math1111,0,Test3,50,77,27
23A10,2016,Fall,MAT192,1,Test3,52,77,25
11A11,2016,Spring,Math 1111,0,Quiz5,59,77,18
13A23,2016,Fall,Math1113,1,Quiz6,65,77,12
13A23,2016,Fall,Math1113,1,Test3,65,77,12
13A10,2016,Fall,Math1113,1,Quiz1,70,77,7
13A10,2016,Fall,Math1113,1,Quiz4,70,77,7
13A10,2016,Fall,Math1113,1,Test1,70,77,7
11A16,2016,Spring,Math 1111,1,Test1,70,77,7
11C9,2016,Spring,Math 2470,1,test3,70,77,7
11A12,2016,Spring,Math 1111,1,Quiz5,73,77,4
11A6,2016,Spring,Math 1111,0,final,74,77,3
13B16,2016,Fall,Math3650,0,Quiz2,75,77,2
13B17,2016,Fall,Math3650,0,Quiz5,75,77,2
13B17,2016,Fall,Math3650,0,Test2,75,77,2
21C25,2016,Spring,192,1,test1,75,77,2
21C15,2016,Spring,192,0,test3,76,77,1
21B3,2016,Spring,192,0,final,79,77,-2
13A7,2016,Fall,Math1113,0,Quiz7,80,77,-3
13D18,2016,Fall,Math1111,0,Quiz3,80,77,-3
13D19,2016,Fall,Math1111,0,Quiz1,80,77,-3
13D19,2016,Fall,Math1111,0,Quiz2,80,77,-3
13D2,2016,Fall,Math1111,0,Test1,80,77,-3
11A6,2016,Spring,Math 1111,0,Quiz2,80,77,-3
13A22,2016,Fall,Math1113,0,Quiz3,82,77,-5
23A12,2016,Fall,MAT192,0,Test3,84,77,-7
13B9,2016,Fall,Math3650,1,Quiz8,85,77,-8
21B29,2016,Spring,192,1,test2,87,77,-10
21B1,2016,Spring,192,0,test1,90,77,-13
13B21,2016,Fall,Math3650,1,Test3,90,77,-13
13B9,2016,Fall,Math3650,1,Quiz6,90,77,-13
21D17,2016,Spring,320,1,final,94,77,-17
13B8,2016,Fall,Math3650,1,Quiz8,97,77,-20
21C22,2016,Spring,192,0,test1,100,77,-23
21C7,2016,Spring,192,1,test3,100,77,-23
23A19,2016,Fall,MAT192,1,Test1,65,78,13
11C14,2016,Spring,Math 2470,1,test2,70,78,8
13B1,2016,Fall,Math3650,0,Final,75,78,3
13D1,2016,Fall,Math1111,0,Final,75,78,3
13D1,2016,Fall,Math1111,0,Quiz8,75,78,3
13D2,2016,Fall,Math1111,0,Quiz3,75,78,3
13D3,2016,Fall,Math1111,0,Quiz1,75,78,3
13D3,2016,Fall,Math1111,0,Quiz2,75,78,3
13D4,2016,Fall,Math1111,0,Test1,75,78,3
41A16,2016,Spring,MATH1120,1,Final,78,78,0
21B20,2016,Spring,192,0,test1,80,78,-2
21C24,2016,Spring,192,0,test1,80,78,-2
31B03,2016,Spring,MATH 2204,0,quiz1,80,78,-2
13A11,2016,Fall,Math1113,0,Quiz2,85,78,-7
13A11,2016,Fall,Math1113,0,Quiz5,85,78,-7
13A11,2016,Fall,Math1113,0,Test2,85,78,-7
41A23,2016,Spring,MATH1120,1,test1,86,78,-8
13B21,2016,Fall,Math3650,1,Quiz5,87,78,-9
13B21,2016,Fall,Math3650,1,Test2,87,78,-9
13B24,2016,Fall,Math3650,1,Quiz2,87,78,-9
13B25,2016,Fall,Math3650,1,Final,87,78,-9
21C2,2016,Spring,192,0,test2,89,78,-11
31B19,2016,Spring,MATH 2204,0,quiz1,90,78,-12
41A33,2016,Spring,MATH1120,0,test1,90,78,-12
23A7,2016,Fall,MAT192,1,Test2,90,78,-12
11A13,2016,Spring,Math 1111,1,Quiz5,90,78,-12
41A11,2016,Spring,MATH1101,0,test1,93,78,-15
21B23,2016,Spring,192,1,test1,93,78,-15
13D19,2016,Fall,Math1111,0,Quiz3,94,78,-16
13D2,2016,Fall,Math1111,0,Quiz1,94,78,-16
13D2,2016,Fall,Math1111,0,Quiz2,94,78,-16
13D3,2016,Fall,Math1111,0,Test1,94,78,-16
21B1,2016,Spring,192,0,final,95,78,-17
13A5,2016,Fall,Math1113,0,Quiz8,96,78,-18
31A10,2016,Spring,MATH 2204,0,quiz2,100,78,-22
31A16,2016,Spring,MATH 2204,1,quiz2,100,78,-22
31B01,2016,Spring,MATH 2204,1,quiz1,100,78,-22
31B06,2016,Spring,MATH 2204,1,quiz1,100,78,-22
41A01,2016,Spring,MATH1101,1,test2,100,78,-22
13D19,2016,Fall,Math1111,0,Final,66,79,13
13D19,2016,Fall,Math1111,0,Quiz8,66,79,13
41A03,2016,Spring,MATH1101,0,test1,70,79,9
23B14,2016,Fall,MAT192,1,Test3,70,79,9
13B14,2016,Fall,Math3650,0,Quiz7,73,79,6
13B22,2016,Fall,Math3650,1,Quiz3,73,79,6
13A4,2016,Fall,Math1113,0,Quiz6,74,79,5
13A4,2016,Fall,Math1113,0,Test3,74,79,5
13A3,2016,Fall,Math1113,1,Quiz1,75,79,4
13A3,2016,Fall,Math1113,1,Quiz4,75,79,4
13A3,2016,Fall,Math1113,1,Test1,75,79,4
13A7,2016,Fall,Math1113,0,Quiz8,78,79,1
13D3,2016,Fall,Math1111,0,Quiz3,80,79,-1
13D4,2016,Fall,Math1111,0,Quiz1,80,79,-1
13D4,2016,Fall,Math1111,0,Quiz2,80,79,-1
13D4,2016,Fall,Math1111,0,Quiz3,80,79,-1
13D5,2016,Fall,Math1111,0,Quiz1,80,79,-1
13D5,2016,Fall,Math1111,0,Quiz2,80,79,-1
13D5,2016,Fall,Math1111,0,Test1,80,79,-1
23B11,2016,Fall,MAT192,0,Test3,80,79,-1
11A7,2016,Spring,Math 1111,0,Test1,80,79,-1
13D6,2016,Fall,Math1111,1,Test1,80,79,-1
31A03,2016,Spring,MATH 2204,1,test1,80,79,-1
21C2,2016,Spring,192,0,test3,83,79,-4
21B22,2016,Spring,192,0,test2,85,79,-6
31A08,2016,Spring,MATH 2204,0,test1,85,79,-6
41A14,2016,Spring,MATH1120,1,Final,87,79,-8
21C16,2016,Spring,192,0,test1,89,79,-10
13B25,2016,Fall,Math3650,1,Quiz7,89,79,-10
21B10,2016,Spring,192,1,test2,89,79,-10
13D1,2016,Fall,Math1111,0,Test1,90,79,-11
13D5,2016,Fall,Math1111,0,Quiz3,90,79,-11
13D6,2016,Fall,Math1111,1,Quiz1,90,79,-11
13D6,2016,Fall,Math1111,1,Quiz2,90,79,-11
23B8,2016,Fall,MAT192,1,Test3,90,79,-11
21C16,2016,Spring,192,0,test3,93,79,-14
21A4,2016,Spring,191,1,final,93,79,-14
41A02,2016,Spring,MATH1101,1,test1,94,79,-15
23B17,2016,Fall,MAT192,0,Test3,95,79,-16
41A01,2016,Spring,MATH1101,1,Final,100,79,-21
23B16,2016,Fall,MAT192,0,Quiz4,40,80,40
23A15,2016,Fall,MAT192,0,Quiz2,50,80,30
23A18,2016,Fall,MAT192,0,Quiz6,50,80,30
23B17,2016,Fall,MAT192,0,Quiz1,50,80,30
11A7,2016,Spring,Math 1111,0,Quiz2,50,80,30
11A9,2016,Spring,Math 1111,0,test1,50,80,30
21C24,2016,Spring,192,0,quiz6,50,80,30
23A20,2016,Fall,MAT192,1,Quiz7,50,80,30
23B5,2016,Fall,MAT192,1,Quiz6,50,80,30
23B7,2016,Fall,MAT192,1,Quiz3,50,80,30
21B13,2016,Spring,192,1,quiz1,50,80,30
21C21,2016,Spring,192,1,quiz6,50,80,30
23A15,2016,Fall,MAT192,0,Test2,55,80,25
23B16,2016,Fall,MAT192,0,Quiz2,60,80,20
21B14,2016,Spring,192,0,test3,60,80,20
13D6,2016,Fall,Math1111,1,Quiz6,60,80,20
13D6,2016,Fall,Math1111,1,Quiz7,60,80,20
13D6,2016,Fall,Math1111,1,Test3,60,80,20
13A6,2016,Fall,Math1113,1,Quiz1,65,80,15
13A6,2016,Fall,Math1113,1,Quiz4,65,80,15
13A6,2016,Fall,Math1113,1,Test1,65,80,15
13B14,2016,Fall,Math3650,0,Quiz6,70,80,10
13B16,2016,Fall,Math3650,0,Test3,70,80,10
23B17,2016,Fall,MAT192,0,Quiz2,70,80,10
11A8,2016,Spring,Math 1111,0,Quiz2,70,80,10
31B25,2016,Spring,MATH 2204,0,quiz2,70,80,10
13A17,2016,Fall,Math1113,1,Quiz2,70,80,10
13A17,2016,Fall,Math1113,1,Quiz5,70,80,10
13A17,2016,Fall,Math1113,1,Test2,70,80,10
13C4,2016,Fall,Math1111,1,Quiz6,70,80,10
13C4,2016,Fall,Math1111,1,Quiz7,70,80,10
13C4,2016,Fall,Math1111,1,Test3,70,80,10
23A2,2016,Fall,MAT192,1,Quiz5,70,80,10
23B14,2016,Fall,MAT192,1,Quiz2,70,80,10
23B14,2016,Fall,MAT192,1,Quiz8,70,80,10
11A17,2016,Spring,Math 1111,1,Quiz2,70,80,10
11A17,2016,Spring,Math 1111,1,test1,70,80,10
21B24,2016,Spring,192,1,quiz6,70,80,10
21C1,2016,Spring,192,1,quiz6,70,80,10
21D10,2016,Spring,320,1,quiz3,70,80,10
21D15,2016,Spring,320,1,quiz6,70,80,10
31B07,2016,Spring,MATH 2204,1,FINAL,70,80,10
31C02,2016,Spring,MATH 2222,1,quiz1,70,80,10
11A10,2016,Spring,Math 1111,0,Final,74,80,6
11A11,2016,Spring,Math 1111,0,final,74,80,6
13B14,2016,Fall,Math3650,0,Quiz3,75,80,5
31B16,2016,Spring,MATH 2204,0,test1,75,80,5
11C12,2016,Spring,Math 2470,1,test3,75,80,5
13A3,2016,Fall,Math1113,1,Quiz3,78,80,2
11A14,2016,Spring,Math 1111,1,Quiz5,78,80,2
11C17,2016,Spring,Math 2470,1,final,78,80,2
11A12,2016,Spring,Math 1111,1,final,79,80,1
13A12,2016,Fall,Math1113,0,Quiz2,80,80,0
13A12,2016,Fall,Math1113,0,Quiz5,80,80,0
13A12,2016,Fall,Math1113,0,Test2,80,80,0
13A20,2016,Fall,Math1113,0,Final,80,80,0
13C13,2016,Fall,Math1111,0,Quiz6,80,80,0
13C13,2016,Fall,Math1111,0,Quiz7,80,80,0
13C13,2016,Fall,Math1111,0,Test3,80,80,0
13D19,2016,Fall,Math1111,0,Quiz4,80,80,0
13D19,2016,Fall,Math1111,0,Quiz5,80,80,0
13D19,2016,Fall,Math1111,0,Test2,80,80,0
23A14,2016,Fall,MAT192,0,Test1,80,80,0
23B11,2016,Fall,MAT192,0,Quiz1,80,80,0
23B13,2016,Fall,MAT192,0,Quiz2,80,80,0
23B13,2016,Fall,MAT192,0,Quiz5,80,80,0
11A9,2016,Spring,Math 1111,0,Quiz2,80,80,0
11A10,2016,Spring,Math 1111,0,Quiz2,80,80,0
11A2,2016,Spring,Math 1111,0,Quiz5,80,80,0
11A10,2016,Spring,Math 1111,0,test1,80,80,0
11A11,2016,Spring,Math 1111,0,test1,80,80,0
21C13,2016,Spring,192,0,quiz6,80,80,0
21C22,2016,Spring,192,0,quiz6,80,80,0
31C04,2016,Spring,MATH 2222,0,quiz1,80,80,0
23A2,2016,Fall,MAT192,1,Quiz6,80,80,0
23B6,2016,Fall,MAT192,1,Quiz6,80,80,0
11A12,2016,Spring,Math 1111,1,Quiz2,80,80,0
11A15,2016,Spring,Math 1111,1,Test3,80,80,0
21B13,2016,Spring,192,1,quiz3,80,80,0
21B21,2016,Spring,192,1,quiz6,80,80,0
21B24,2016,Spring,192,1,quiz4,80,80,0
21C26,2016,Spring,192,1,quiz2,80,80,0
21D13,2016,Spring,320,1,test1,80,80,0
41A36,2016,Spring,MATH3313,1,test1,80,80,0
11A7,2016,Spring,Math 1111,0,Test3,81,80,-1
23A2,2016,Fall,MAT192,1,Final,81,80,-1
21D3,2016,Spring,320,0,test1,82,80,-2
11A15,2016,Spring,Math 1111,1,Quiz5,84,80,-4
13B14,2016,Fall,Math3650,0,Quiz2,85,80,-5
13B14,2016,Fall,Math3650,0,Test2,85,80,-5
13B15,2016,Fall,Math3650,0,Quiz5,85,80,-5
13D2,2016,Fall,Math1111,0,Quiz4,85,80,-5
13D2,2016,Fall,Math1111,0,Quiz5,85,80,-5
13D2,2016,Fall,Math1111,0,Test2,85,80,-5
11A1,2016,Spring,Math 1111,0,Quiz2,85,80,-5
21B13,2016,Spring,192,1,test3,85,80,-5
41A17,2016,Spring,MATH1120,1,test2,85,80,-5
13A19,2016,Fall,Math1113,0,Final,86,80,-6
23A14,2016,Fall,MAT192,0,Final,86,80,-6
11A3,2016,Spring,Math 1111,0,Quiz5,87,80,-7
13B27,2016,Fall,Math3650,1,Quiz5,88,80,-8
13B27,2016,Fall,Math3650,1,Test2,88,80,-8
13B4,2016,Fall,Math3650,1,Quiz2,88,80,-8
11C14,2016,Spring,Math 2470,1,test4,89,80,-9
21C12,2016,Spring,192,0,test3,90,80,-10
21C23,2016,Spring,192,0,test2,90,80,-10
21C8,2016,Spring,192,0,quiz2,90,80,-10
31A04,2016,Spring,MATH 2204,0,quiz3,90,80,-10
31A12,2016,Spring,MATH 2204,0,quiz1,90,80,-10
31B09,2016,Spring,MATH 2204,0,quiz2,90,80,-10
11A12,2016,Spring,Math 1111,1,test1,90,80,-10
21A4,2016,Spring,191,1,quiz1,90,80,-10
21A4,2016,Spring,191,1,quiz2,90,80,-10
11A8,2016,Spring,Math 1111,0,Test3,91,80,-11
13A23,2016,Fall,Math1113,1,Quiz7,91,80,-11
21B5,2016,Spring,192,1,test1,92,80,-12
21C17,2016,Spring,192,1,test2,92,80,-12
13D7,2016,Fall,Math1111,1,Quiz1,93,80,-13
13D7,2016,Fall,Math1111,1,Quiz2,93,80,-13
13D9,2016,Fall,Math1111,1,Quiz4,93,80,-13
13D9,2016,Fall,Math1111,1,Quiz5,93,80,-13
13D9,2016,Fall,Math1111,1,Test2,93,80,-13
31A01,2016,Spring,MATH 2204,0,Final,94,80,-14
21C1,2016,Spring,192,1,test3,95,80,-15
21C25,2016,Spring,192,1,quiz5,95,80,-15
21D6,2016,Spring,320,1,quiz1,95,80,-15
21A4,2016,Spring,191,1,test2,96,80,-16
11A2,2016,Spring,Math 1111,0,test1,100,80,-20
11A3,2016,Spring,Math 1111,0,test1,100,80,-20
11A4,2016,Spring,Math 1111,0,test1,100,80,-20
21A1,2016,Spring,191,0,quiz7,100,80,-20
21A3,2016,Spring,191,0,quiz9,100,80,-20
21A6,2016,Spring,191,0,quiz7,100,80,-20
21C14,2016,Spring,192,0,quiz2,100,80,-20
21C14,2016,Spring,192,0,quiz3,100,80,-20
21C15,2016,Spring,192,0,quiz3,100,80,-20
21C16,2016,Spring,192,0,quiz1,100,80,-20
21C23,2016,Spring,192,0,quiz6,100,80,-20
21C6,2016,Spring,192,0,quiz2,100,80,-20
21C6,2016,Spring,192,0,quiz5,100,80,-20
31A11,2016,Spring,MATH 2204,0,quiz1,100,80,-20
31A13,2016,Spring,MATH 2204,0,quiz1,100,80,-20
31A18,2016,Spring,MATH 2204,0,quiz1,100,80,-20
31A18,2016,Spring,MATH 2204,0,quiz3,100,80,-20
31B03,2016,Spring,MATH 2204,0,quiz2,100,80,-20
31B23,2016,Spring,MATH 2204,0,quiz2,100,80,-20
23A3,2016,Fall,MAT192,1,Quiz8,100,80,-20
23B10,2016,Fall,MAT192,1,Quiz6,100,80,-20
23B6,2016,Fall,MAT192,1,Quiz4,100,80,-20
23B8,2016,Fall,MAT192,1,Quiz7,100,80,-20
11A13,2016,Spring,Math 1111,1,test1,100,80,-20
11A14,2016,Spring,Math 1111,1,test1,100,80,-20
21A5,2016,Spring,191,1,quiz1,100,80,-20
21A5,2016,Spring,191,1,quiz2,100,80,-20
21B12,2016,Spring,192,1,quiz1,100,80,-20
21B2,2016,Spring,192,1,quiz4,100,80,-20
21B23,2016,Spring,192,1,quiz2,100,80,-20
21B24,2016,Spring,192,1,quiz1,100,80,-20
21B29,2016,Spring,192,1,quiz3,100,80,-20
21C11,2016,Spring,192,1,test1,100,80,-20
31A15,2016,Spring,MATH 2204,1,quiz1,100,80,-20
31B07,2016,Spring,MATH 2204,1,quiz2,100,80,-20
31C03,2016,Spring,MATH 2222,1,quiz1,100,80,-20
11C3,2016,Spring,Math 2470,0,test2,85,80.5,-4.5
23B16,2016,Fall,MAT192,0,Test3,67,81,14
41A11,2016,Spring,MATH1101,0,Final,71,81,10
13A23,2016,Fall,Math1113,1,Quiz8,78,81,3
13D18,2016,Fall,Math1111,0,Quiz6,80,81,1
13D18,2016,Fall,Math1111,0,Quiz7,80,81,1
13D18,2016,Fall,Math1111,0,Test3,80,81,1
11A5,2016,Spring,Math 1111,0,Test1,80,81,1
13A24,2016,Fall,Math1113,0,Quiz3,81,81,0
13D2,2016,Fall,Math1111,0,Final,81,81,0
13D2,2016,Fall,Math1111,0,Quiz8,81,81,0
11A9,2016,Spring,Math 1111,0,Test3,82,81,-1
13D3,2016,Fall,Math1111,0,Quiz4,83,81,-2
13D3,2016,Fall,Math1111,0,Quiz5,83,81,-2
13D3,2016,Fall,Math1111,0,Test2,83,81,-2
13D3,2016,Fall,Math1111,0,Final,84,81,-3
13D3,2016,Fall,Math1111,0,Quiz8,84,81,-3
41A06,2016,Spring,MATH1101,0,Final,86,81,-5
11A10,2016,Spring,Math 1111,0,Test3,87,81,-6
41A13,2016,Spring,MATH1120,1,test2,90,81,-9
21B19,2016,Spring,192,0,test1,91,81,-10
31B09,2016,Spring,MATH 2204,0,test1,94,81,-13
31B04,2016,Spring,MATH 2204,1,test1,99,81,-18
41A31,2016,Spring,MATH1120,1,Final,100,81,-19
13A18,2016,Fall,Math1113,1,Quiz2,64,82,18
13A18,2016,Fall,Math1113,1,Quiz5,64,82,18
13A18,2016,Fall,Math1113,1,Test2,64,82,18
11C19,2016,Spring,Math 2470,1,test4,65,82,17
31A17,2016,Spring,MATH 2204,0,test1,70,82,12
13B6,2016,Fall,Math3650,1,Final,70,82,12
31A16,2016,Spring,MATH 2204,1,Final,70,82,12
13B2,2016,Fall,Math3650,1,Quiz1,72,82,10
13B6,2016,Fall,Math3650,1,Quiz4,72,82,10
13B6,2016,Fall,Math3650,1,Test1,72,82,10
21B9,2016,Spring,192,1,final,74,82,8
13D19,2016,Fall,Math1111,0,Quiz6,80,82,2
13D19,2016,Fall,Math1111,0,Quiz7,80,82,2
13D19,2016,Fall,Math1111,0,Test3,80,82,2
11A11,2016,Spring,Math 1111,0,Test3,80,82,2
31B18,2016,Spring,MATH 2204,0,FINAL,80,82,2
13B26,2016,Fall,Math3650,1,Quiz3,80,82,2
21C26,2016,Spring,192,1,test3,80,82,2
13A22,2016,Fall,Math1113,0,Quiz1,81,82,1
13A22,2016,Fall,Math1113,0,Quiz4,81,82,1
13A22,2016,Fall,Math1113,0,Test1,81,82,1
21B11,2016,Spring,192,1,final,84,82,-2
11C6,2016,Spring,Math 2470,0,final,85,82,-3
11C17,2016,Spring,Math 2470,1,test3,85,82,-3
13B8,2016,Fall,Math3650,1,Quiz7,86,82,-4
21A1,2016,Spring,191,0,final,88,82,-6
23A8,2016,Fall,MAT192,0,Final,89,82,-7
31B23,2016,Spring,MATH 2204,0,test1,90,82,-8
41A34,2016,Spring,MATH1120,0,test1,90,82,-8
13A21,2016,Fall,Math1113,0,Final,92,82,-10
21C14,2016,Spring,192,0,test3,93,82,-11
41A09,2016,Spring,MATH1101,1,test1,94,82,-12
31A02,2016,Spring,MATH 2204,0,Final,95,82,-13
21D8,2016,Spring,320,1,test2,95,82,-13
31A15,2016,Spring,MATH 2204,1,Final,95,82,-13
41A09,2016,Spring,MATH1101,1,test2,95,82,-13
41A08,2016,Spring,MATH1101,0,test1,97,82,-15
23A3,2016,Fall,MAT192,1,Final,100,82,-18
21B15,2016,Spring,192,1,final,100,82,-18
41A29,2016,Spring,MATH1120,1,test3,100,82,-18
13D1,2016,Fall,Math1111,0,Quiz3,60,83,23
13D2,2016,Fall,Math1111,0,Quiz6,60,83,23
13D2,2016,Fall,Math1111,0,Quiz7,60,83,23
13D2,2016,Fall,Math1111,0,Test3,60,83,23
21C8,2016,Spring,192,0,test1,70,83,13
13B21,2016,Fall,Math3650,1,Quiz2,70,83,13
13B21,2016,Fall,Math3650,1,Quiz5,70,83,13
13B26,2016,Fall,Math3650,1,Test2,70,83,13
11A13,2016,Spring,Math 1111,1,Quiz2,70,83,13
21B14,2016,Spring,192,0,test1,73,83,10
41A34,2016,Spring,MATH1120,0,Final,73,83,10
11A2,2016,Spring,Math 1111,0,Quiz2,75,83,8
21D15,2016,Spring,320,1,test2,75,83,8
13A22,2016,Fall,Math1113,0,Final,80,83,3
13D4,2016,Fall,Math1111,0,Quiz4,80,83,3
13D4,2016,Fall,Math1111,0,Quiz5,80,83,3
13D4,2016,Fall,Math1111,0,Test2,80,83,3
11A4,2016,Spring,Math 1111,0,Quiz5,80,83,3
11A6,2016,Spring,Math 1111,0,Test1,80,83,3
13D7,2016,Fall,Math1111,1,Final,80,83,3
13D7,2016,Fall,Math1111,1,Quiz8,80,83,3
11A14,2016,Spring,Math 1111,1,Quiz2,80,83,3
21D16,2016,Spring,320,1,final,80,83,3
23A7,2016,Fall,MAT192,1,Final,81,83,2
11A12,2016,Spring,Math 1111,1,Test3,82,83,1
21B17,2016,Spring,192,1,test2,82,83,1
21B6,2016,Spring,192,1,test2,83,83,0
21A6,2016,Spring,191,0,final,84,83,-1
13B24,2016,Fall,Math3650,1,Quiz4,85,83,-2
13B27,2016,Fall,Math3650,1,Test1,85,83,-2
13B8,2016,Fall,Math3650,1,Quiz1,85,83,-2
41A38,2016,Spring,MATH3315,1,test1,85,83,-2
41A23,2016,Spring,MATH1120,1,test3,87,83,-4
13B1,2016,Fall,Math3650,0,Quiz4,90,83,-7
13B13,2016,Fall,Math3650,0,Quiz7,90,83,-7
13B14,2016,Fall,Math3650,0,Quiz8,90,83,-7
13B15,2016,Fall,Math3650,0,Test1,90,83,-7
13B16,2016,Fall,Math3650,0,Quiz1,90,83,-7
11A1,2016,Spring,Math 1111,0,Quiz1,90,83,-7
31B10,2016,Spring,MATH 2204,0,test1,90,83,-7
13B13,2016,Fall,Math3650,0,Quiz8,92,83,-9
13B22,2016,Fall,Math3650,1,Quiz4,92,83,-9
13B26,2016,Fall,Math3650,1,Test1,92,83,-9
13B6,2016,Fall,Math3650,1,Quiz1,92,83,-9
41A11,2016,Spring,MATH1101,0,test2,93,83,-10
21C11,2016,Spring,192,1,test2,93,83,-10
41A02,2016,Spring,MATH1101,1,Final,94,83,-11
21B12,2016,Spring,192,1,test3,98,83,-15
11C3,2016,Spring,Math 2470,0,test4,53,84,31
13D8,2016,Fall,Math1111,1,Final,60,84,24
13D8,2016,Fall,Math1111,1,Quiz8,60,84,24
31B21,2016,Spring,MATH 2204,1,FINAL,75,84,9
13D3,2016,Fall,Math1111,0,Quiz6,76,84,8
13D3,2016,Fall,Math1111,0,Quiz7,76,84,8
13D3,2016,Fall,Math1111,0,Test3,76,84,8
41A22,2016,Spring,MATH1120,1,test2,76,84,8
13B1,2016,Fall,Math3650,0,Quiz8,78,84,6
21D11,2016,Spring,320,1,test2,78,84,6
31B23,2016,Spring,MATH 2204,0,test2,80,84,4
13B6,2016,Fall,Math3650,1,Quiz6,80,84,4
13B6,2016,Fall,Math3650,1,Test3,80,84,4
13D7,2016,Fall,Math1111,1,Quiz3,80,84,4
13D8,2016,Fall,Math1111,1,Quiz6,80,84,4
13D8,2016,Fall,Math1111,1,Quiz7,80,84,4
13D8,2016,Fall,Math1111,1,Test3,80,84,4
13A5,2016,Fall,Math1113,0,Quiz6,82,84,2
13A5,2016,Fall,Math1113,0,Test3,82,84,2
21C23,2016,Spring,192,0,final,82,84,2
11A16,2016,Spring,Math 1111,1,Quiz5,82,84,2
13A5,2016,Fall,Math1113,0,Quiz2,84,84,0
13A5,2016,Fall,Math1113,0,Quiz5,84,84,0
13A5,2016,Fall,Math1113,0,Test2,84,84,0
23B8,2016,Fall,MAT192,1,Test2,84,84,0
41A25,2016,Spring,MATH1120,1,test3,84,84,0
31A19,2016,Spring,MATH 2204,0,test1,85,84,-1
21D7,2016,Spring,320,1,test2,85,84,-1
13D5,2016,Fall,Math1111,0,Quiz4,87,84,-3
13D5,2016,Fall,Math1111,0,Quiz5,87,84,-3
13D5,2016,Fall,Math1111,0,Test2,87,84,-3
41A33,2016,Spring,MATH1120,0,test3,87,84,-3
11C7,2016,Spring,Math 2470,1,test2,87,84,-3
13B15,2016,Fall,Math3650,0,Quiz3,88,84,-4
11C11,2016,Spring,Math 2470,1,final,88,84,-4
21B29,2016,Spring,192,1,test3,88,84,-4
21C12,2016,Spring,192,0,final,89,84,-5
31A10,2016,Spring,MATH 2204,0,Final,90,84,-6
31B08,2016,Spring,MATH 2204,0,FINAL,90,84,-6
31B08,2016,Spring,MATH 2204,0,test2,90,84,-6
13B6,2016,Fall,Math3650,1,Test3,90,84,-6
13B7,2016,Fall,Math3650,1,Quiz6,90,84,-6
21C4,2016,Spring,192,1,test2,90,84,-6
21C17,2016,Spring,192,1,final,91,84,-7
13B24,2016,Fall,Math3650,1,Quiz1,93,84,-9
13B27,2016,Fall,Math3650,1,Quiz4,93,84,-9
13B27,2016,Fall,Math3650,1,Quiz6,93,84,-9
13B6,2016,Fall,Math3650,1,Test1,93,84,-9
13B6,2016,Fall,Math3650,1,Test3,93,84,-9
21D2,2016,Spring,320,0,test3,95,84,-11
23B13,2016,Fall,MAT192,0,Final,98,84,-14
21A1,2016,Spring,191,0,test2,100,84,-16
11A16,2016,Spring,Math 1111,1,Quiz1,100,84,-16
13B7,2016,Fall,Math3650,1,Final,80,84.5,4.5
23A20,2016,Fall,MAT192,1,Test3,45,85,40
11C18,2016,Spring,Math 2470,1,test4,68,85,17
23A7,2016,Fall,MAT192,1,Test3,71,85,14
13B2,2016,Fall,Math3650,1,Quiz3,75,85,10
13B26,2016,Fall,Math3650,1,Quiz4,75,85,10
13B26,2016,Fall,Math3650,1,Test1,75,85,10
13B9,2016,Fall,Math3650,1,Quiz1,75,85,10
13B4,2016,Fall,Math3650,1,Quiz8,78,85,7
23A15,2016,Fall,MAT192,0,Quiz7,80,85,5
11C4,2016,Spring,Math 2470,0,test3,80,85,5
41A06,2016,Spring,MATH1101,0,test1,80,85,5
13B21,2016,Fall,Math3650,1,Quiz2,80,85,5
13B22,2016,Fall,Math3650,1,Quiz5,80,85,5
13B25,2016,Fall,Math3650,1,Quiz4,80,85,5
13B25,2016,Fall,Math3650,1,Test2,80,85,5
13B26,2016,Fall,Math3650,1,Test1,80,85,5
13B6,2016,Fall,Math3650,1,Quiz1,80,85,5
11C23,2016,Spring,Math 2470,1,test3,80,85,5
21C6,2016,Spring,192,0,final,82,85,3
41A33,2016,Spring,MATH1120,0,Final,84,85,1
13D8,2016,Fall,Math1111,1,Quiz3,85,85,0
13D9,2016,Fall,Math1111,1,Quiz6,85,85,0
13D9,2016,Fall,Math1111,1,Quiz7,85,85,0
13D9,2016,Fall,Math1111,1,Test3,85,85,0
11C12,2016,Spring,Math 2470,1,final,85,85,0
13A4,2016,Fall,Math1113,0,Quiz3,86,85,-1
21D16,2016,Spring,320,1,test2,86,85,-1
13A23,2016,Fall,Math1113,1,Final,87,85,-2
13A24,2016,Fall,Math1113,0,Quiz1,88,85,-3
13A24,2016,Fall,Math1113,0,Quiz4,88,85,-3
13A24,2016,Fall,Math1113,0,Test1,88,85,-3
13B12,2016,Fall,Math3650,0,Quiz4,90,85,-5
13B14,2016,Fall,Math3650,0,Test1,90,85,-5
13B17,2016,Fall,Math3650,0,Quiz1,90,85,-5
13D10,2016,Fall,Math1111,0,Quiz1,90,85,-5
13D10,2016,Fall,Math1111,0,Quiz2,90,85,-5
13B27,2016,Fall,Math3650,1,Final,90,85,-5
13D6,2016,Fall,Math1111,1,Quiz4,90,85,-5
13D6,2016,Fall,Math1111,1,Quiz5,90,85,-5
13D6,2016,Fall,Math1111,1,Test2,90,85,-5
41A02,2016,Spring,MATH1101,1,test2,91,85,-6
21C16,2016,Spring,192,0,final,93,85,-8
11A3,2016,Spring,Math 1111,0,Quiz2,95,85,-10
23A3,2016,Fall,MAT192,1,Test1,95,85,-10
21B11,2016,Spring,192,1,test2,98,85,-13
23A19,2016,Fall,MAT192,1,Quiz8,100,85,-15
21B6,2016,Spring,192,1,quiz4,100,85,-15
41A35,2016,Spring,MATH1120,1,test2,100,85,-15
13B6,2016,Fall,Math3650,1,Quiz2,60,86,26
13B6,2016,Fall,Math3650,1,Quiz5,60,86,26
13B9,2016,Fall,Math3650,1,Test2,60,86,26
13B6,2016,Fall,Math3650,1,Quiz6,64,86,22
13B8,2016,Fall,Math3650,1,Test3,64,86,22
13D10,2016,Fall,Math1111,0,Quiz4,70,86,16
13D10,2016,Fall,Math1111,0,Quiz5,70,86,16
13D10,2016,Fall,Math1111,0,Test2,70,86,16
13D4,2016,Fall,Math1111,0,Final,80,86,6
13D4,2016,Fall,Math1111,0,Quiz6,80,86,6
13D4,2016,Fall,Math1111,0,Quiz7,80,86,6
13D4,2016,Fall,Math1111,0,Quiz8,80,86,6
13D4,2016,Fall,Math1111,0,Test3,80,86,6
11A4,2016,Spring,Math 1111,0,Quiz2,80,86,6
13B7,2016,Fall,Math3650,1,Quiz8,80,86,6
13D9,2016,Fall,Math1111,1,Final,80,86,6
13D9,2016,Fall,Math1111,1,Quiz8,80,86,6
21B7,2016,Spring,192,1,test2,81,86,5
41A33,2016,Spring,MATH1120,0,test2,82,86,4
13D5,2016,Fall,Math1111,0,Quiz6,83,86,3
13D5,2016,Fall,Math1111,0,Quiz7,83,86,3
13D5,2016,Fall,Math1111,0,Test3,83,86,3
13B4,2016,Fall,Math3650,1,Quiz6,85,86,1
13B7,2016,Fall,Math3650,1,Test3,85,86,1
11A13,2016,Spring,Math 1111,1,Test3,85,86,1
11C16,2016,Spring,Math 2470,1,final,86,86,0
21D17,2016,Spring,320,1,test3,88,86,-2
41A39,2016,Spring,MATH3316,0,test1,89,86,-3
11C20,2016,Spring,Math 2470,1,test3,89,86,-3
13B15,2016,Fall,Math3650,0,Quiz8,90,86,-4
13A10,2016,Fall,Math1113,1,Quiz8,90,86,-4
13B6,2016,Fall,Math3650,1,Quiz3,90,86,-4
23A19,2016,Fall,MAT192,1,Final,90,86,-4
11C21,2016,Spring,Math 2470,1,final,90,86,-4
31B11,2016,Spring,MATH 2204,1,test1,90,86,-4
13B16,2016,Fall,Math3650,0,Quiz8,91,86,-5
21C14,2016,Spring,192,0,final,91,86,-5
13A14,2016,Fall,Math1113,1,Quiz7,93,86,-7
13A12,2016,Fall,Math1113,0,Quiz7,94,86,-8
13B26,2016,Fall,Math3650,1,Quiz7,94,86,-8
13B1,2016,Fall,Math3650,0,Quiz6,95,86,-9
13B1,2016,Fall,Math3650,0,Test3,95,86,-9
13B8,2016,Fall,Math3650,1,Quiz6,95,86,-9
13B9,2016,Fall,Math3650,1,Test3,95,86,-9
23B13,2016,Fall,MAT192,0,Test1,96,86,-10
31B15,2016,Spring,MATH 2204,1,test1,99,86,-13
11C15,2016,Spring,Math 2470,1,test2,82,86.5,4.5
13D11,2016,Fall,Math1111,0,Test1,65,87,22
21D6,2016,Spring,320,1,test2,67,87,20
13D10,2016,Fall,Math1111,0,Final,68,87,19
13D10,2016,Fall,Math1111,0,Quiz8,68,87,19
21A7,2016,Spring,191,1,final,69,87,18
13D10,2016,Fall,Math1111,0,Quiz3,73,87,14
13D10,2016,Fall,Math1111,0,Test1,73,87,14
13D11,2016,Fall,Math1111,0,Quiz1,73,87,14
13D11,2016,Fall,Math1111,0,Quiz2,73,87,14
13D5,2016,Fall,Math1111,0,Final,75,87,12
13D5,2016,Fall,Math1111,0,Quiz8,75,87,12
11C3,2016,Spring,Math 2470,0,test3,80,87,7
11C18,2016,Spring,Math 2470,1,test3,80,87,7
21C19,2016,Spring,192,0,test2,82,87,5
13B12,2016,Fall,Math3650,0,Quiz8,85,87,2
21C21,2016,Spring,192,1,final,86,87,1
11A14,2016,Spring,Math 1111,1,Test3,87,87,0
13B12,2016,Fall,Math3650,0,Quiz6,88,87,-1
13B14,2016,Fall,Math3650,0,Test3,88,87,-1
11A1,2016,Spring,Math 1111,0,Test3,90,87,-3
31A13,2016,Spring,MATH 2204,0,test1,90,87,-3
11C7,2016,Spring,Math 2470,1,final,90,87,-3
11C16,2016,Spring,Math 2470,1,test3,90,87,-3
21D1,2016,Spring,320,1,final,90,87,-3
13B21,2016,Fall,Math3650,1,Quiz1,92,87,-5
13B25,2016,Fall,Math3650,1,Test1,92,87,-5
13B26,2016,Fall,Math3650,1,Quiz4,92,87,-5
13B12,2016,Fall,Math3650,0,Quiz7,93,87,-6
11A2,2016,Spring,Math 1111,0,Test3,93,87,-6
21C10,2016,Spring,192,0,test3,95,87,-8
41A28,2016,Spring,MATH1120,0,test3,100,87,-13
13D1,2016,Fall,Math1111,0,Quiz6,39,88,49
13D1,2016,Fall,Math1111,0,Quiz7,39,88,49
13D1,2016,Fall,Math1111,0,Test3,39,88,49
13D11,2016,Fall,Math1111,0,Quiz3,39,88,49
21B6,2016,Spring,192,1,test1,70,88,18
11A15,2016,Spring,Math 1111,1,Quiz2,72,88,16
23A15,2016,Fall,MAT192,0,Final,78,88,10
11A1,2016,Spring,Math 1111,0,Quiz3,80,88,8
11A7,2016,Spring,Math 1111,0,Quiz3,80,88,8
31B16,2016,Spring,MATH 2204,0,FINAL,80,88,8
13A6,2016,Fall,Math1113,1,Quiz3,80,88,8
11A14,2016,Spring,Math 1111,1,Quiz3,80,88,8
21A5,2016,Spring,191,1,final,80,88,8
21B23,2016,Spring,192,1,final,80,88,8
31B21,2016,Spring,MATH 2204,1,test1,80,88,8
13A19,2016,Fall,Math1113,0,Quiz7,85,88,3
13D12,2016,Fall,Math1111,0,Quiz4,85,88,3
13D12,2016,Fall,Math1111,0,Quiz5,85,88,3
13D12,2016,Fall,Math1111,0,Test2,85,88,3
23B5,2016,Fall,MAT192,1,Test2,85,88,3
11C18,2016,Spring,Math 2470,1,final,85,88,3
13A4,2016,Fall,Math1113,0,Quiz1,86,88,2
13A4,2016,Fall,Math1113,0,Quiz4,86,88,2
13A4,2016,Fall,Math1113,0,Test1,86,88,2
11A5,2016,Spring,Math 1111,0,Quiz5,86,88,2
13B24,2016,Fall,Math3650,1,Quiz6,86,88,2
13B26,2016,Fall,Math3650,1,Test3,86,88,2
13D11,2016,Fall,Math1111,0,Quiz4,88,88,0
13D11,2016,Fall,Math1111,0,Quiz5,88,88,0
13D11,2016,Fall,Math1111,0,Test2,88,88,0
13B12,2016,Fall,Math3650,0,Final,90,88,-2
23A8,2016,Fall,MAT192,0,Test2,90,88,-2
21B7,2016,Spring,192,1,test3,91,88,-3
13D8,2016,Fall,Math1111,1,Test1,93,88,-5
13B26,2016,Fall,Math3650,1,Quiz3,95,88,-7
13B4,2016,Fall,Math3650,1,Final,95,88,-7
41A28,2016,Spring,MATH1120,0,test2,97,88,-9
21D2,2016,Spring,320,0,test2,100,88,-12
31A18,2016,Spring,MATH 2204,0,Final,100,88,-12
23B10,2016,Fall,MAT192,1,Test2,100,88,-12
21B5,2016,Spring,192,1,final,100,88,-12
41A25,2016,Spring,MATH1120,1,test1,100,88,-12
13A15,2016,Fall,Math1113,1,Quiz8,69,89,20
13B14,2016,Fall,Math3650,0,Quiz5,70,89,19
13B15,2016,Fall,Math3650,0,Quiz2,70,89,19
13B16,2016,Fall,Math3650,0,Test2,70,89,19
13D11,2016,Fall,Math1111,0,Final,70,89,19
13D11,2016,Fall,Math1111,0,Quiz8,70,89,19
13D12,2016,Fall,Math1111,0,Test1,70,89,19
31A12,2016,Spring,MATH 2204,0,quiz2,70,89,19
13D12,2016,Fall,Math1111,0,Final,80,89,9
13D12,2016,Fall,Math1111,0,Quiz8,80,89,9
31B19,2016,Spring,MATH 2204,0,test1,80,89,9
21C19,2016,Spring,192,0,final,82,89,7
41A14,2016,Spring,MATH1120,1,test1,84,89,5
13B7,2016,Fall,Math3650,1,Quiz7,85,89,4
21B16,2016,Spring,192,1,test2,87,89,2
21B21,2016,Spring,192,1,test2,87,89,2
13A2,2016,Fall,Math1113,0,Quiz7,88,89,1
13B2,2016,Fall,Math3650,1,Quiz4,88,89,1
13B25,2016,Fall,Math3650,1,Quiz1,88,89,1
13B6,2016,Fall,Math3650,1,Test1,88,89,1
21C24,2016,Spring,192,0,final,89,89,0
21C24,2016,Spring,192,0,test2,90,89,-1
31A19,2016,Spring,MATH 2204,0,quiz2,90,89,-1
31B08,2016,Spring,MATH 2204,0,quiz1,90,89,-1
13B7,2016,Fall,Math3650,1,Quiz3,90,89,-1
31B15,2016,Spring,MATH 2204,1,quiz1,90,89,-1
41A14,2016,Spring,MATH1120,1,test2,90,89,-1
13B6,2016,Fall,Math3650,1,Quiz3,91,89,-2
23A7,2016,Fall,MAT192,1,Test1,92,89,-3
13B9,2016,Fall,Math3650,1,Quiz7,93,89,-4
13B6,2016,Fall,Math3650,1,Quiz3,94,89,-5
13A7,2016,Fall,Math1113,0,Quiz6,95,89,-6
13A7,2016,Fall,Math1113,0,Test3,95,89,-6
21C1,2016,Spring,192,1,final,97,89,-8
21D2,2016,Spring,320,0,final,100,89,-11
31A02,2016,Spring,MATH 2204,0,quiz2,100,89,-11
31A11,2016,Spring,MATH 2204,0,quiz2,100,89,-11
31A18,2016,Spring,MATH 2204,0,test1,100,89,-11
31B09,2016,Spring,MATH 2204,0,quiz1,100,89,-11
31B12,2016,Spring,MATH 2204,0,quiz1,100,89,-11
31A14,2016,Spring,MATH 2204,1,quiz2,100,89,-11
31B04,2016,Spring,MATH 2204,1,quiz1,100,89,-11
31B13,2016,Spring,MATH 2204,1,quiz1,100,89,-11
21A7,2016,Spring,191,1,quiz3,40,90,50
21A7,2016,Spring,191,1,quiz7,40,90,50
23A18,2016,Fall,MAT192,0,Quiz8,50,90,40
13D10,2016,Fall,Math1111,0,Quiz6,54,90,36
13D10,2016,Fall,Math1111,0,Quiz7,54,90,36
13D10,2016,Fall,Math1111,0,Test3,54,90,36
11A9,2016,Spring,Math 1111,0,Quiz1,60,90,30
21B20,2016,Spring,192,0,quiz6,60,90,30
31A10,2016,Spring,MATH 2204,0,quiz1,60,90,30
31A12,2016,Spring,MATH 2204,0,quiz3,60,90,30
11C19,2016,Spring,Math 2470,1,final,67,90,23
13A16,2016,Fall,Math1113,1,Quiz8,68,90,22
23B11,2016,Fall,MAT192,0,Quiz8,70,90,20
23B4,2016,Fall,MAT192,0,Quiz1,70,90,20
11C5,2016,Spring,Math 2470,0,final,70,90,20
21A6,2016,Spring,191,0,quiz4,70,90,20
31A17,2016,Spring,MATH 2204,0,quiz3,70,90,20
23A10,2016,Fall,MAT192,1,Quiz7,70,90,20
23B7,2016,Fall,MAT192,1,Quiz1,70,90,20
11A16,2016,Spring,Math 1111,1,Test3,70,90,20
21C1,2016,Spring,192,1,quiz5,70,90,20
21C18,2016,Spring,192,1,quiz5,70,90,20
13B14,2016,Fall,Math3650,0,Quiz8,74,90,16
21C25,2016,Spring,192,1,quiz4,75,90,15
11C16,2016,Spring,Math 2470,1,test4,76,90,14
13D13,2016,Fall,Math1111,0,Final,77,90,13
13D13,2016,Fall,Math1111,0,Quiz8,77,90,13
21D15,2016,Spring,320,1,test1,77,90,13
13B14,2016,Fall,Math3650,0,Quiz1,80,90,10
13B14,2016,Fall,Math3650,0,Quiz4,80,90,10
13B14,2016,Fall,Math3650,0,Quiz4,80,90,10
13B15,2016,Fall,Math3650,0,Quiz1,80,90,10
13B16,2016,Fall,Math3650,0,Test1,80,90,10
13B17,2016,Fall,Math3650,0,Test1,80,90,10
23A18,2016,Fall,MAT192,0,Quiz7,80,90,10
23B4,2016,Fall,MAT192,0,Quiz7,80,90,10
21A3,2016,Spring,191,0,quiz4,80,90,10
21C15,2016,Spring,192,0,quiz5,80,90,10
31A17,2016,Spring,MATH 2204,0,quiz1,80,90,10
13D7,2016,Fall,Math1111,1,Quiz4,80,90,10
13D7,2016,Fall,Math1111,1,Quiz5,80,90,10
13D7,2016,Fall,Math1111,1,Quiz6,80,90,10
13D7,2016,Fall,Math1111,1,Quiz7,80,90,10
13D7,2016,Fall,Math1111,1,Test2,80,90,10
13D7,2016,Fall,Math1111,1,Test3,80,90,10
13D8,2016,Fall,Math1111,1,Quiz1,80,90,10
13D8,2016,Fall,Math1111,1,Quiz2,80,90,10
13D9,2016,Fall,Math1111,1,Quiz3,80,90,10
13D9,2016,Fall,Math1111,1,Test1,80,90,10
11C20,2016,Spring,Math 2470,1,test4,80,90,10
21B18,2016,Spring,192,1,quiz1,80,90,10
21B21,2016,Spring,192,1,quiz1,80,90,10
21B8,2016,Spring,192,1,quiz4,80,90,10
21C11,2016,Spring,192,1,quiz5,80,90,10
21C17,2016,Spring,192,1,quiz5,80,90,10
31B04,2016,Spring,MATH 2204,1,test2,80,90,10
21D11,2016,Spring,320,1,test1,81,90,9
13B12,2016,Fall,Math3650,0,Quiz3,85,90,5
13D14,2016,Fall,Math1111,0,Final,85,90,5
13D14,2016,Fall,Math1111,0,Quiz8,85,90,5
11A3,2016,Spring,Math 1111,0,Test3,86,90,4
11A15,2016,Spring,Math 1111,1,Quiz3,88,90,2
21C1,2016,Spring,192,1,test2,88,90,2
13B21,2016,Fall,Math3650,1,Quiz3,89,90,1
13B26,2016,Fall,Math3650,1,Quiz7,89,90,1
23B13,2016,Fall,MAT192,0,Quiz3,90,90,0
21A3,2016,Spring,191,0,quiz6,90,90,0
21A6,2016,Spring,191,0,quiz1,90,90,0
21B27,2016,Spring,192,0,quiz1,90,90,0
21B3,2016,Spring,192,0,quiz4,90,90,0
21C12,2016,Spring,192,0,quiz5,90,90,0
21C22,2016,Spring,192,0,quiz5,90,90,0
21C24,2016,Spring,192,0,quiz4,90,90,0
31A10,2016,Spring,MATH 2204,0,quiz3,90,90,0
31B03,2016,Spring,MATH 2204,0,test1,90,90,0
31B14,2016,Spring,MATH 2204,0,test1,90,90,0
13B22,2016,Fall,Math3650,1,Quiz2,90,90,0
13B24,2016,Fall,Math3650,1,Test2,90,90,0
13B25,2016,Fall,Math3650,1,Quiz2,90,90,0
13B26,2016,Fall,Math3650,1,Quiz2,90,90,0
13B26,2016,Fall,Math3650,1,Quiz5,90,90,0
13B26,2016,Fall,Math3650,1,Quiz5,90,90,0
13B4,2016,Fall,Math3650,1,Quiz5,90,90,0
13B6,2016,Fall,Math3650,1,Test2,90,90,0
13B6,2016,Fall,Math3650,1,Test2,90,90,0
11C22,2016,Spring,Math 2470,1,final,90,90,0
21C4,2016,Spring,192,1,quiz5,90,90,0
41A04,2016,Spring,MATH1101,1,test1,90,90,0
41A25,2016,Spring,MATH1120,1,Final,91,90,-1
41A38,2016,Spring,MATH3319,1,test2,91,90,-1
13B13,2016,Fall,Math3650,0,Quiz3,92,90,-2
11C10,2016,Spring,Math 2470,1,test2,92,90,-2
13B1,2016,Fall,Math3650,0,Test2,93,90,-3
13B13,2016,Fall,Math3650,0,Quiz5,93,90,-3
13B17,2016,Fall,Math3650,0,Quiz2,93,90,-3
11C14,2016,Spring,Math 2470,1,final,93,90,-3
41A04,2016,Spring,MATH1101,1,Final,93,90,-3
13B15,2016,Fall,Math3650,0,Final,95,90,-5
13B26,2016,Fall,Math3650,1,Quiz2,95,90,-5
13B6,2016,Fall,Math3650,1,Quiz5,95,90,-5
13B6,2016,Fall,Math3650,1,Test2,95,90,-5
21B23,2016,Spring,192,1,test3,96,90,-6
21D9,2016,Spring,320,1,test1,96,90,-6
13A23,2016,Fall,Math1113,1,Quiz2,97,90,-7
13A23,2016,Fall,Math1113,1,Quiz5,97,90,-7
13A23,2016,Fall,Math1113,1,Test2,97,90,-7
11A4,2016,Spring,Math 1111,0,Test3,98,90,-8
11A10,2016,Spring,Math 1111,0,Quiz1,100,90,-10
11A11,2016,Spring,Math 1111,0,Quiz1,100,90,-10
21A2,2016,Spring,191,0,quiz8,100,90,-10
21B19,2016,Spring,192,0,quiz6,100,90,-10
21B20,2016,Spring,192,0,quiz4,100,90,-10
21B20,2016,Spring,192,0,quiz5,100,90,-10
21C10,2016,Spring,192,0,quiz1,100,90,-10
21C13,2016,Spring,192,0,quiz4,100,90,-10
21C19,2016,Spring,192,0,quiz2,100,90,-10
21C2,2016,Spring,192,0,quiz1,100,90,-10
21C23,2016,Spring,192,0,quiz5,100,90,-10
21C5,2016,Spring,192,0,quiz4,100,90,-10
31A01,2016,Spring,MATH 2204,0,quiz2,100,90,-10
31A09,2016,Spring,MATH 2204,0,quiz1,100,90,-10
23A10,2016,Fall,MAT192,1,Quiz1,100,90,-10
23B10,2016,Fall,MAT192,1,Quiz7,100,90,-10
23B10,2016,Fall,MAT192,1,Final,100,90,-10
23B2,2016,Fall,MAT192,1,Quiz4,100,90,-10
23B5,2016,Fall,MAT192,1,Quiz1,100,90,-10
23B5,2016,Fall,MAT192,1,Quiz5,100,90,-10
23B8,2016,Fall,MAT192,1,Quiz4,100,90,-10
21A4,2016,Spring,191,1,quiz8,100,90,-10
21A4,2016,Spring,191,1,quiz9,100,90,-10
21B15,2016,Spring,192,1,quiz6,100,90,-10
21B18,2016,Spring,192,1,quiz5,100,90,-10
21C1,2016,Spring,192,1,quiz3,100,90,-10
21C18,2016,Spring,192,1,test3,100,90,-10
21C20,2016,Spring,192,1,quiz1,100,90,-10
21C20,2016,Spring,192,1,quiz5,100,90,-10
21C25,2016,Spring,192,1,quiz1,100,90,-10
21C26,2016,Spring,192,1,quiz4,100,90,-10
21C3,2016,Spring,192,1,quiz4,100,90,-10
21D1,2016,Spring,320,1,quiz3,100,90,-10
21D9,2016,Spring,320,1,quiz3,100,90,-10
41A07,2016,Spring,MATH1101,1,test1,92,90.5,-1.5
23A2,2016,Fall,MAT192,1,Test3,65,91,26
13D11,2016,Fall,Math1111,0,Quiz6,70,91,21
13D11,2016,Fall,Math1111,0,Quiz7,70,91,21
13D11,2016,Fall,Math1111,0,Test3,70,91,21
13D12,2016,Fall,Math1111,0,Quiz3,70,91,21
13B24,2016,Fall,Math3650,1,Test1,71,91,20
13B6,2016,Fall,Math3650,1,Quiz1,71,91,20
13B8,2016,Fall,Math3650,1,Quiz4,71,91,20
13B26,2016,Fall,Math3650,1,Quiz8,75,91,16
41A30,2016,Spring,MATH1120,1,test3,75,91,16
11A6,2016,Spring,Math 1111,0,Quiz5,80,91,11
11C7,2016,Spring,Math 2470,1,test3,80,91,11
41A30,2016,Spring,MATH1120,1,Final,82,91,9
13B26,2016,Fall,Math3650,1,Quiz8,83,91,8
13A13,2016,Fall,Math1113,0,Quiz3,84,91,7
13A3,2016,Fall,Math1113,1,Quiz7,84,91,7
13B21,2016,Fall,Math3650,1,Quiz7,86,91,5
13B2,2016,Fall,Math3650,1,Quiz7,88,91,3
13B26,2016,Fall,Math3650,1,Final,88,91,3
11A7,2016,Spring,Math 1111,0,Quiz5,89,91,2
13B14,2016,Fall,Math3650,0,Test3,90,91,1
13B17,2016,Fall,Math3650,0,Quiz6,90,91,1
11A5,2016,Spring,Math 1111,0,Test3,90,91,1
21D7,2016,Spring,320,1,test1,90,91,1
31C03,2016,Spring,MATH 2222,1,FINAL,90,91,1
13B25,2016,Fall,Math3650,1,Quiz8,92,91,-1
11C8,2016,Spring,Math 2470,1,final,92,91,-1
11C23,2016,Spring,Math 2470,1,final,93,91,-2
21B1,2016,Spring,192,0,test2,94,91,-3
41A34,2016,Spring,MATH1120,0,test2,95,91,-4
21C5,2016,Spring,192,0,test2,96,91,-5
13A24,2016,Fall,Math1113,0,Final,100,91,-9
11A8,2016,Spring,Math 1111,0,Quiz3,100,91,-9
13D8,2016,Fall,Math1111,1,Quiz4,100,91,-9
13D8,2016,Fall,Math1111,1,Quiz5,100,91,-9
13D8,2016,Fall,Math1111,1,Test2,100,91,-9
13D9,2016,Fall,Math1111,1,Quiz1,100,91,-9
13D9,2016,Fall,Math1111,1,Quiz2,100,91,-9
11C4,2016,Spring,Math 2470,0,test2,60,91.5,31.5
11C20,2016,Spring,Math 2470,1,test2,83,91.5,8.5
11A12,2016,Spring,Math 1111,1,Quiz1,60,92,32
31B10,2016,Spring,MATH 2204,0,FINAL,70,92,22
13B4,2016,Fall,Math3650,1,Quiz7,74,92,18
13A3,2016,Fall,Math1113,1,Quiz8,75,92,17
11A6,2016,Spring,Math 1111,0,Test3,76,92,16
13D13,2016,Fall,Math1111,0,Quiz4,80,92,12
13D13,2016,Fall,Math1111,0,Quiz5,80,92,12
13D13,2016,Fall,Math1111,0,Test2,80,92,12
31B19,2016,Spring,MATH 2204,0,FINAL,80,92,12
13A13,2016,Fall,Math1113,0,Quiz8,81,92,11
21B21,2016,Spring,192,1,final,81,92,11
13D15,2016,Fall,Math1111,0,Final,85,92,7
13D15,2016,Fall,Math1111,0,Quiz8,85,92,7
13A14,2016,Fall,Math1113,1,Quiz6,87,92,5
13A14,2016,Fall,Math1113,1,Test3,87,92,5
13B22,2016,Fall,Math3650,1,Quiz1,89,92,3
13B26,2016,Fall,Math3650,1,Quiz4,89,92,3
13B6,2016,Fall,Math3650,1,Test1,89,92,3
13A13,2016,Fall,Math1113,0,Quiz6,90,92,2
13A13,2016,Fall,Math1113,0,Test3,90,92,2
21B26,2016,Spring,192,0,test2,90,92,2
13D6,2016,Fall,Math1111,1,Final,90,92,2
13D6,2016,Fall,Math1111,1,Quiz8,90,92,2
11C13,2016,Spring,Math 2470,1,final,90,92,2
11C9,2016,Spring,Math 2470,1,test2,90,92,2
11C13,2016,Spring,Math 2470,1,test2,90,92,2
21B11,2016,Spring,192,1,test3,90,92,2
31B11,2016,Spring,MATH 2204,1,FINAL,90,92,2
41A04,2016,Spring,MATH1101,1,test2,90,92,2
13A19,2016,Fall,Math1113,0,Quiz3,91,92,1
13B1,2016,Fall,Math3650,0,Test1,91,92,1
13B12,2016,Fall,Math3650,0,Quiz1,91,92,1
13B14,2016,Fall,Math3650,0,Quiz4,91,92,1
13B6,2016,Fall,Math3650,1,Quiz3,91,92,1
13D12,2016,Fall,Math1111,0,Quiz1,93,92,-1
13D12,2016,Fall,Math1111,0,Quiz2,93,92,-1
13D13,2016,Fall,Math1111,0,Quiz3,93,92,-1
13D13,2016,Fall,Math1111,0,Test1,93,92,-1
13B4,2016,Fall,Math3650,1,Quiz3,93,92,-1
13B15,2016,Fall,Math3650,0,Quiz7,94,92,-2
13B6,2016,Fall,Math3650,1,Quiz8,94,92,-2
13D12,2016,Fall,Math1111,0,Quiz6,95,92,-3
13D12,2016,Fall,Math1111,0,Quiz7,95,92,-3
13D12,2016,Fall,Math1111,0,Test3,95,92,-3
23A14,2016,Fall,MAT192,0,Test2,95,92,-3
21C10,2016,Spring,192,0,test1,95,92,-3
11A17,2016,Spring,Math 1111,1,Test3,96,92,-4
21C16,2016,Spring,192,0,test2,97,92,-5
13B6,2016,Fall,Math3650,1,Quiz7,98,92,-6
21C18,2016,Spring,192,1,test2,100,92,-8
31B07,2016,Spring,MATH 2204,1,test1,100,92,-8
41A26,2016,Spring,MATH1120,1,test2,100,92,-8
41A29,2016,Spring,MATH1120,1,test1,100,92,-8
41A29,2016,Spring,MATH1120,1,test2,100,92,-8
41A36,2016,Spring,MATH3321,1,Final,100,92,-8
11A1,2016,Spring,Math 1111,0,Test2,75,93,18
13B2,2016,Fall,Math3650,1,Test2,75,93,18
13B7,2016,Fall,Math3650,1,Quiz2,75,93,18
13B8,2016,Fall,Math3650,1,Quiz5,75,93,18
11C21,2016,Spring,Math 2470,1,test3,75,93,18
11A14,2016,Spring,Math 1111,1,Test2,76,93,17
21B13,2016,Spring,192,1,test2,78,93,15
23A12,2016,Fall,MAT192,0,Test2,80,93,13
13B24,2016,Fall,Math3650,1,Final,80,93,13
11C10,2016,Spring,Math 2470,1,test3,80,93,13
13B12,2016,Fall,Math3650,0,Test3,85,93,8
13B16,2016,Fall,Math3650,0,Quiz6,85,93,8
21B21,2016,Spring,192,1,test1,85,93,8
13B21,2016,Fall,Math3650,1,Final,90,93,3
23A19,2016,Fall,MAT192,1,Test2,90,93,3
11C11,2016,Spring,Math 2470,1,test3,90,93,3
11C14,2016,Spring,Math 2470,1,test3,90,93,3
21C2,2016,Spring,192,0,test1,91,93,2
13A2,2016,Fall,Math1113,0,Quiz3,92,93,1
13B17,2016,Fall,Math3650,0,Quiz3,93,93,0
13B21,2016,Fall,Math3650,1,Final,93,93,0
23A12,2016,Fall,MAT192,0,Final,94,93,-1
13D13,2016,Fall,Math1111,0,Quiz1,95,93,-2
13D13,2016,Fall,Math1111,0,Quiz2,95,93,-2
13D14,2016,Fall,Math1111,0,Quiz3,95,93,-2
13D14,2016,Fall,Math1111,0,Test1,95,93,-2
21A6,2016,Spring,191,0,test2,95,93,-2
13B26,2016,Fall,Math3650,1,Quiz1,95,93,-2
13B6,2016,Fall,Math3650,1,Quiz4,95,93,-2
13B9,2016,Fall,Math3650,1,Test1,95,93,-2
11C13,2016,Spring,Math 2470,1,test3,95,93,-2
41A26,2016,Spring,MATH1120,1,test3,98,93,-5
21C14,2016,Spring,192,0,test2,100,93,-7
21B12,2016,Spring,192,1,test2,100,93,-7
21B15,2016,Spring,192,1,test1,100,93,-7
11C4,2016,Spring,Math 2470,0,test4,68,94,26
13D15,2016,Fall,Math1111,0,Test1,75,94,19
23A5,2016,Fall,MAT192,0,Final,79,94,15
13D13,2016,Fall,Math1111,0,Quiz6,80,94,14
13D13,2016,Fall,Math1111,0,Quiz7,80,94,14
13D13,2016,Fall,Math1111,0,Test3,80,94,14
13D14,2016,Fall,Math1111,0,Quiz1,80,94,14
13D14,2016,Fall,Math1111,0,Quiz2,80,94,14
13D14,2016,Fall,Math1111,0,Quiz4,80,94,14
13D14,2016,Fall,Math1111,0,Quiz5,80,94,14
13D14,2016,Fall,Math1111,0,Test2,80,94,14
13D16,2016,Fall,Math1111,0,Final,80,94,14
13D16,2016,Fall,Math1111,0,Quiz8,80,94,14
11A9,2016,Spring,Math 1111,0,Quiz3,80,94,14
11A13,2016,Spring,Math 1111,1,Quiz1,80,94,14
41A30,2016,Spring,MATH1120,1,test1,80,94,14
31B24,2016,Spring,MATH 2204,0,test1,85,94,9
11A16,2016,Spring,Math 1111,1,Quiz3,85,94,9
21C17,2016,Spring,192,1,test1,87,94,7
13B14,2016,Fall,Math3650,0,Quiz6,88,94,6
13B14,2016,Fall,Math3650,0,Test3,88,94,6
13B14,2016,Fall,Math3650,0,Quiz7,89,94,5
21C19,2016,Spring,192,0,test1,89,94,5
31B09,2016,Spring,MATH 2204,0,FINAL,90,94,4
13A14,2016,Fall,Math1113,1,Quiz3,90,94,4
21B5,2016,Spring,192,1,test3,90,94,4
41A34,2016,Spring,MATH1120,0,test3,93,94,1
13B14,2016,Fall,Math3650,0,Quiz3,94,94,0
13B12,2016,Fall,Math3650,0,Quiz2,95,94,-1
13B12,2016,Fall,Math3650,0,Quiz5,95,94,-1
13B13,2016,Fall,Math3650,0,Test2,95,94,-1
13B14,2016,Fall,Math3650,0,Quiz7,95,94,-1
31B20,2016,Spring,MATH 2204,0,FINAL,95,94,-1
11C20,2016,Spring,Math 2470,1,final,95,94,-1
11C15,2016,Spring,Math 2470,1,test3,95,94,-1
11C24,2016,Spring,Math 2470,1,test3,95,94,-1
31B15,2016,Spring,MATH 2204,1,FINAL,95,94,-1
41A30,2016,Spring,MATH1120,1,test2,95,94,-1
41A26,2016,Spring,MATH1120,1,Final,98,94,-4
21C12,2016,Spring,192,0,test2,100,94,-6
21B15,2016,Spring,192,1,test3,100,94,-6
21C21,2016,Spring,192,1,test2,100,94,-6
21C3,2016,Spring,192,1,test2,100,94,-6
11C16,2016,Spring,Math 2470,1,test2,97,94.5,-2.5
23A5,2016,Fall,MAT192,0,Quiz6,50,95,45
23B16,2016,Fall,MAT192,0,Quiz8,50,95,45
23B14,2016,Fall,MAT192,1,Quiz7,60,95,35
11C5,2016,Spring,Math 2470,0,test3,65,95,30
13D14,2016,Fall,Math1111,0,Quiz6,70,95,25
13D14,2016,Fall,Math1111,0,Quiz7,70,95,25
13D14,2016,Fall,Math1111,0,Test3,70,95,25
23B4,2016,Fall,MAT192,0,Quiz3,70,95,25
21B27,2016,Spring,192,0,quiz2,70,95,25
21B27,2016,Spring,192,0,quiz4,70,95,25
23A7,2016,Fall,MAT192,1,Quiz4,70,95,25
21C5,2016,Spring,192,0,test1,75,95,20
23A19,2016,Fall,MAT192,1,Test3,75,95,20
11C2,2016,Spring,Math 2470,0,test3,78,95,17
13D17,2016,Fall,Math1111,0,Final,80,95,15
13D17,2016,Fall,Math1111,0,Quiz8,80,95,15
23A8,2016,Fall,MAT192,0,Quiz3,80,95,15
23A8,2016,Fall,MAT192,0,Quiz4,80,95,15
23A8,2016,Fall,MAT192,0,Quiz7,80,95,15
23B4,2016,Fall,MAT192,0,Quiz2,80,95,15
21D3,2016,Spring,320,0,quiz1,80,95,15
13A10,2016,Fall,Math1113,1,Quiz2,80,95,15
13A10,2016,Fall,Math1113,1,Quiz5,80,95,15
13A10,2016,Fall,Math1113,1,Test2,80,95,15
13A3,2016,Fall,Math1113,1,Quiz2,80,95,15
13A3,2016,Fall,Math1113,1,Quiz5,80,95,15
13A3,2016,Fall,Math1113,1,Test2,80,95,15
23A2,2016,Fall,MAT192,1,Quiz2,80,95,15
21C9,2016,Spring,192,1,quiz2,80,95,15
13B6,2016,Fall,Math3650,1,Quiz8,82,95,13
21B6,2016,Spring,192,1,final,88,95,7
13D15,2016,Fall,Math1111,0,Quiz4,90,95,5
13D15,2016,Fall,Math1111,0,Quiz5,90,95,5
13D15,2016,Fall,Math1111,0,Test2,90,95,5
21B20,2016,Spring,192,0,quiz2,90,95,5
21D14,2016,Spring,320,0,final,90,95,5
13B26,2016,Fall,Math3650,1,Final,90,95,5
21B21,2016,Spring,192,1,quiz4,90,95,5
13B14,2016,Fall,Math3650,0,Final,92,95,3
13A12,2016,Fall,Math1113,0,Quiz1,93,95,2
13A12,2016,Fall,Math1113,0,Quiz4,93,95,2
13A12,2016,Fall,Math1113,0,Test1,93,95,2
13B14,2016,Fall,Math3650,0,Final,93,95,2
13B16,2016,Fall,Math3650,0,Quiz3,93,95,2
13B14,2016,Fall,Math3650,0,Quiz8,94,95,1
13A15,2016,Fall,Math1113,1,Quiz1,94,95,1
13A15,2016,Fall,Math1113,1,Quiz4,94,95,1
13A15,2016,Fall,Math1113,1,Test1,94,95,1
13B2,2016,Fall,Math3650,1,Final,97,95,-2
13A20,2016,Fall,Math1113,0,Quiz7,98,95,-3
41A38,2016,Spring,MATH3323,1,Final,98,95,-3
23A15,2016,Fall,MAT192,0,Quiz4,100,95,-5
23A8,2016,Fall,MAT192,0,Quiz6,100,95,-5
21B19,2016,Spring,192,0,quiz4,100,95,-5
21C14,2016,Spring,192,0,quiz6,100,95,-5
21C22,2016,Spring,192,0,test2,100,95,-5
23A2,2016,Fall,MAT192,1,Quiz7,100,95,-5
23A3,2016,Fall,MAT192,1,Quiz7,100,95,-5
23A7,2016,Fall,MAT192,1,Quiz7,100,95,-5
23B10,2016,Fall,MAT192,1,Quiz3,100,95,-5
23B10,2016,Fall,MAT192,1,Quiz8,100,95,-5
23B5,2016,Fall,MAT192,1,Quiz2,100,95,-5
11A14,2016,Spring,Math 1111,1,Quiz1,100,95,-5
21B15,2016,Spring,192,1,test2,100,95,-5
21B6,2016,Spring,192,1,quiz2,100,95,-5
21B6,2016,Spring,192,1,quiz5,100,95,-5
41A24,2016,Spring,MATH1120,1,test1,100,95,-5
11C17,2016,Spring,Math 2470,1,test2,97,95.5,-1.5
13D16,2016,Fall,Math1111,0,Quiz1,66,96,30
13D16,2016,Fall,Math1111,0,Quiz2,66,96,30
13D17,2016,Fall,Math1111,0,Quiz4,66,96,30
13D17,2016,Fall,Math1111,0,Quiz5,66,96,30
13D17,2016,Fall,Math1111,0,Test2,66,96,30
13B26,2016,Fall,Math3650,1,Quiz8,73,96,23
13B21,2016,Fall,Math3650,1,Test2,78,96,18
13B8,2016,Fall,Math3650,1,Quiz2,78,96,18
13B9,2016,Fall,Math3650,1,Quiz5,78,96,18
13D15,2016,Fall,Math1111,0,Quiz1,80,96,16
13D15,2016,Fall,Math1111,0,Quiz2,80,96,16
13D16,2016,Fall,Math1111,0,Quiz4,80,96,16
13D16,2016,Fall,Math1111,0,Quiz5,80,96,16
13D16,2016,Fall,Math1111,0,Test2,80,96,16
11A10,2016,Spring,Math 1111,0,Quiz3,80,96,16
21B27,2016,Spring,192,0,test1,80,96,16
13A15,2016,Fall,Math1113,1,Quiz6,80,96,16
13A15,2016,Fall,Math1113,1,Test3,80,96,16
13A16,2016,Fall,Math1113,1,Quiz1,80,96,16
13A16,2016,Fall,Math1113,1,Quiz4,80,96,16
13A16,2016,Fall,Math1113,1,Test1,80,96,16
11A17,2016,Spring,Math 1111,1,Quiz3,80,96,16
11C8,2016,Spring,Math 2470,1,test3,85,96,11
41A39,2016,Spring,MATH3324,0,Final,86,96,10
13A17,2016,Fall,Math1113,1,Quiz1,89,96,7
13A17,2016,Fall,Math1113,1,Quiz4,89,96,7
13A17,2016,Fall,Math1113,1,Test1,89,96,7
13B12,2016,Fall,Math3650,0,Test1,90,96,6
13B14,2016,Fall,Math3650,0,Quiz1,90,96,6
13B16,2016,Fall,Math3650,0,Quiz4,90,96,6
11C1,2016,Spring,Math 2470,0,test3,90,96,6
21C6,2016,Spring,192,0,test1,90,96,6
31A01,2016,Spring,MATH2204,0,test1,90,96,6
23B6,2016,Fall,MAT192,1,Test2,90,96,6
21C26,2016,Spring,192,1,test2,90,96,6
41A24,2016,Spring,MATH1120,1,Final,93,96,3
13B13,2016,Fall,Math3650,0,Test1,94,96,2
13B14,2016,Fall,Math3650,0,Quiz1,94,96,2
13B17,2016,Fall,Math3650,0,Quiz4,94,96,2
11C9,2016,Spring,Math 2470,1,final,94,96,2
41A08,2016,Spring,MATH1101,0,test2,95,96,1
13A9,2016,Fall,Math1113,1,Quiz3,95,96,1
23B13,2016,Fall,MAT192,0,Test3,96,96,0
41A31,2016,Spring,MATH1120,1,test1,96,96,0
13A13,2016,Fall,Math1113,0,Quiz2,98,96,-2
13A13,2016,Fall,Math1113,0,Quiz5,98,96,-2
13A13,2016,Fall,Math1113,0,Test2,98,96,-2
21B7,2016,Spring,192,1,final,98,96,-2
11A2,2016,Spring,Math 1111,0,Quiz1,100,96,-4
41A28,2016,Spring,MATH1120,0,Final,100,96,-4
13B2,2016,Fall,Math3650,1,Quiz5,100,96,-4
13B21,2016,Fall,Math3650,1,Quiz6,100,96,-4
13B22,2016,Fall,Math3650,1,Test2,100,96,-4
13B24,2016,Fall,Math3650,1,Test3,100,96,-4
13B9,2016,Fall,Math3650,1,Quiz2,100,96,-4
23B10,2016,Fall,MAT192,1,Test3,100,96,-4
11A17,2016,Spring,Math 1111,1,Quiz1,100,96,-4
21B2,2016,Spring,192,1,test2,100,96,-4
21B23,2016,Spring,192,1,test2,100,96,-4
41A31,2016,Spring,MATH1120,1,test2,100,96,-4
13A19,2016,Fall,Math1113,0,Quiz8,72,97,25
23A12,2016,Fall,MAT192,0,Test1,77,97,20
11A7,2016,Spring,Math 1111,0,Test2,79,97,18
13B21,2016,Fall,Math3650,1,Quiz8,79,97,18
31B07,2016,Spring,MATH 2204,1,test2,80,97,17
13B8,2016,Fall,Math3650,1,Final,84,97,13
11C21,2016,Spring,Math 2470,1,test2,85,97,12
13B16,2016,Fall,Math3650,0,Quiz7,87,97,10
13B6,2016,Fall,Math3650,1,Quiz8,88,97,9
21B16,2016,Spring,192,1,final,88,97,9
31B08,2016,Spring,MATH 2204,0,test1,90,97,7
13B9,2016,Fall,Math3650,1,Final,91,97,6
11C11,2016,Spring,Math 2470,1,test4,91,97,6
31B09,2016,Spring,MATH 2204,0,test2,93,97,4
13B6,2016,Fall,Math3650,1,Quiz2,93,97,4
13B6,2016,Fall,Math3650,1,Quiz5,93,97,4
13B6,2016,Fall,Math3650,1,Test2,93,97,4
13B13,2016,Fall,Math3650,0,Quiz1,94,97,3
13B14,2016,Fall,Math3650,0,Quiz2,94,97,3
13B14,2016,Fall,Math3650,0,Test1,94,97,3
13B15,2016,Fall,Math3650,0,Quiz4,94,97,3
13B15,2016,Fall,Math3650,0,Test2,94,97,3
13B16,2016,Fall,Math3650,0,Quiz5,94,97,3
13B6,2016,Fall,Math3650,1,Quiz2,95,97,2
13B6,2016,Fall,Math3650,1,Quiz5,95,97,2
13B7,2016,Fall,Math3650,1,Test2,95,97,2
41A31,2016,Spring,MATH1120,1,test3,95,97,2
13A20,2016,Fall,Math1113,0,Quiz3,96,97,1
41A23,2016,Spring,MATH1120,1,Final,96,97,1
41A24,2016,Spring,MATH1120,1,test3,96,97,1
13B16,2016,Fall,Math3650,0,Final,100,97,-3
13B17,2016,Fall,Math3650,0,Final,100,97,-3
21C12,2016,Spring,192,0,test1,100,97,-3
21D2,2016,Spring,320,0,test1,100,97,-3
21A5,2016,Spring,191,1,test2,100,97,-3
21B18,2016,Spring,192,1,final,100,97,-3
41A23,2016,Spring,MATH1120,1,test2,100,97,-3
41A29,2016,Spring,MATH1120,1,Final,100,97,-3
11C18,2016,Spring,Math 2470,1,test2,85,97.5,12.5
11C5,2016,Spring,Math 2470,0,test2,95,97.5,2.5
13D16,2016,Fall,Math1111,0,Test1,61,98,37
11C3,2016,Spring,Math 2470,0,final,73,98,25
13D18,2016,Fall,Math1111,0,Final,80,98,18
13D18,2016,Fall,Math1111,0,Quiz8,80,98,18
41A32,2016,Spring,MATH1120,1,test1,82,98,16
21A7,2016,Spring,191,1,test2,83,98,15
13A8,2016,Fall,Math1113,0,Quiz6,90,98,8
13A8,2016,Fall,Math1113,0,Test3,90,98,8
11A3,2016,Spring,Math 1111,0,Quiz1,90,98,8
41A39,2016,Spring,MATH3320,0,test2,90,98,8
21D7,2016,Spring,320,1,test3,90,98,8
41A37,2016,Spring,MATH3314,1,test1,91,98,7
41A08,2016,Spring,MATH1101,0,Final,92,98,6
13B1,2016,Fall,Math3650,0,Quiz7,94,98,4
21C19,2016,Spring,192,0,test3,94,98,4
11C10,2016,Spring,Math 2470,1,final,94,98,4
41A24,2016,Spring,MATH1120,1,test2,94,98,4
13A19,2016,Fall,Math1113,0,Quiz6,95,98,3
13A19,2016,Fall,Math1113,0,Test3,95,98,3
13B1,2016,Fall,Math3650,0,Quiz2,95,98,3
13B1,2016,Fall,Math3650,0,Quiz5,95,98,3
13B12,2016,Fall,Math3650,0,Test2,95,98,3
41A25,2016,Spring,MATH1120,1,test2,95,98,3
13B1,2016,Fall,Math3650,0,Quiz3,97,98,1
11C4,2016,Spring,Math 2470,0,final,98,98,0
11A4,2016,Spring,Math 1111,0,Quiz1,100,98,-2
11A8,2016,Spring,Math 1111,0,Test2,100,98,-2
13B22,2016,Fall,Math3650,1,Quiz7,100,98,-2
13B26,2016,Fall,Math3650,1,Final,100,98,-2
23B5,2016,Fall,MAT192,1,Final,100,98,-2
11A15,2016,Spring,Math 1111,1,Test2,100,98,-2
13D15,2016,Fall,Math1111,0,Quiz3,55,99,44
13D15,2016,Fall,Math1111,0,Quiz6,55,99,44
13D15,2016,Fall,Math1111,0,Quiz7,55,99,44
13D15,2016,Fall,Math1111,0,Test3,55,99,44
21B14,2016,Spring,192,0,final,82,99,17
13A13,2016,Fall,Math1113,0,Quiz1,86,99,13
13A13,2016,Fall,Math1113,0,Quiz4,86,99,13
13A13,2016,Fall,Math1113,0,Test1,86,99,13
13B14,2016,Fall,Math3650,0,Quiz2,90,99,9
13B14,2016,Fall,Math3650,0,Quiz5,90,99,9
13B14,2016,Fall,Math3650,0,Test2,90,99,9
13A16,2016,Fall,Math1113,1,Quiz6,90,99,9
13A16,2016,Fall,Math1113,1,Test3,90,99,9
23B6,2016,Fall,MAT192,1,Test1,90,99,9
21C17,2016,Spring,192,1,test3,95,99,4
13A19,2016,Fall,Math1113,0,Quiz2,96,99,3
13A19,2016,Fall,Math1113,0,Quiz5,96,99,3
13A19,2016,Fall,Math1113,0,Test2,96,99,3
13A5,2016,Fall,Math1113,0,Quiz1,96,99,3
13A5,2016,Fall,Math1113,0,Quiz4,96,99,3
13A5,2016,Fall,Math1113,0,Test1,96,99,3
13B13,2016,Fall,Math3650,0,Quiz2,100,99,-1
13B14,2016,Fall,Math3650,0,Quiz5,100,99,-1
13B14,2016,Fall,Math3650,0,Test2,100,99,-1
23A3,2016,Fall,MAT192,1,Test2,100,99,-1
21C18,2016,Spring,192,1,test1,100,99,-1
21B17,2016,Spring,192,1,quiz4,40,100,60
21A6,2016,Spring,191,0,quiz6,50,100,50
21D16,2016,Spring,320,1,quiz3,50,100,50
21D16,2016,Spring,320,1,quiz4,50,100,50
23A12,2016,Fall,MAT192,0,Quiz5,60,100,40
23A5,2016,Fall,MAT192,0,Quiz5,60,100,40
23A19,2016,Fall,MAT192,1,Quiz2,60,100,40
23B14,2016,Fall,MAT192,1,Quiz5,60,100,40
21B5,2016,Spring,192,1,quiz4,60,100,40
21B8,2016,Spring,192,1,quiz5,60,100,40
13D17,2016,Fall,Math1111,0,Quiz6,70,100,30
13D17,2016,Fall,Math1111,0,Quiz7,70,100,30
13D17,2016,Fall,Math1111,0,Test3,70,100,30
23A12,2016,Fall,MAT192,0,Quiz3,70,100,30
23A12,2016,Fall,MAT192,0,Quiz7,70,100,30
23A12,2016,Fall,MAT192,0,Quiz8,70,100,30
11A11,2016,Spring,Math 1111,0,Quiz3,70,100,30
21A2,2016,Spring,191,0,quiz6,70,100,30
21B14,2016,Spring,192,0,quiz2,70,100,30
23B6,2016,Fall,MAT192,1,Quiz2,70,100,30
21A7,2016,Spring,191,1,quiz9,70,100,30
21B29,2016,Spring,192,1,quiz2,70,100,30
21D15,2016,Spring,320,1,quiz1,70,100,30
21A7,2016,Spring,191,1,quiz1,75,100,25
13D16,2016,Fall,Math1111,0,Quiz6,80,100,20
13D16,2016,Fall,Math1111,0,Quiz7,80,100,20
13D16,2016,Fall,Math1111,0,Test3,80,100,20
23A15,2016,Fall,MAT192,0,Quiz1,80,100,20
23A15,2016,Fall,MAT192,0,Quiz3,80,100,20
23A15,2016,Fall,MAT192,0,Quiz8,80,100,20
23A5,2016,Fall,MAT192,0,Quiz7,80,100,20
23A8,2016,Fall,MAT192,0,Quiz5,80,100,20
23B16,2016,Fall,MAT192,0,Quiz7,80,100,20
11A2,2016,Spring,Math 1111,0,Quiz3,80,100,20
21A3,2016,Spring,191,0,quiz5,80,100,20
21C10,2016,Spring,192,0,quiz2,80,100,20
21C10,2016,Spring,192,0,quiz6,80,100,20
21C24,2016,Spring,192,0,quiz1,80,100,20
31B20,2016,Spring,MATH 2204,0,quiz1,80,100,20
23A2,2016,Fall,MAT192,1,Quiz1,80,100,20
23B6,2016,Fall,MAT192,1,Quiz5,80,100,20
21B16,2016,Spring,192,1,quiz5,80,100,20
21B21,2016,Spring,192,1,quiz2,80,100,20
21B8,2016,Spring,192,1,quiz3,80,100,20
21C18,2016,Spring,192,1,quiz3,80,100,20
13A2,2016,Fall,Math1113,0,Quiz2,82,100,18
13A2,2016,Fall,Math1113,0,Quiz5,82,100,18
13A2,2016,Fall,Math1113,0,Test2,82,100,18
23A14,2016,Fall,MAT192,0,Test3,82,100,18
31B20,2016,Spring,MATH 2204,0,test1,83,100,17
11A3,2016,Spring,Math 1111,0,Quiz3,85,100,15
11A4,2016,Spring,Math 1111,0,Quiz3,85,100,15
21C23,2016,Spring,192,0,test1,85,100,15
21C9,2016,Spring,192,1,quiz5,85,100,15
13B13,2016,Fall,Math3650,0,Final,86,100,14
11A5,2016,Spring,Math 1111,0,Quiz3,89,100,11
21D6,2016,Spring,320,1,test1,89,100,11
13A20,2016,Fall,Math1113,0,Quiz2,90,100,10
13A20,2016,Fall,Math1113,0,Quiz5,90,100,10
13A20,2016,Fall,Math1113,0,Test2,90,100,10
23A12,2016,Fall,MAT192,0,Quiz1,90,100,10
23A14,2016,Fall,MAT192,0,Quiz6,90,100,10
23A5,2016,Fall,MAT192,0,Quiz1,90,100,10
23A5,2016,Fall,MAT192,0,Quiz2,90,100,10
23A5,2016,Fall,MAT192,0,Quiz3,90,100,10
23A5,2016,Fall,MAT192,0,Quiz4,90,100,10
23B13,2016,Fall,MAT192,0,Quiz8,90,100,10
11A6,2016,Spring,Math 1111,0,Quiz3,90,100,10
21B1,2016,Spring,192,0,quiz1,90,100,10
21B26,2016,Spring,192,0,quiz6,90,100,10
21B27,2016,Spring,192,0,quiz5,90,100,10
21C13,2016,Spring,192,0,quiz5,90,100,10
21C15,2016,Spring,192,0,quiz6,90,100,10
21C19,2016,Spring,192,0,quiz3,90,100,10
21C2,2016,Spring,192,0,quiz2,90,100,10
21C24,2016,Spring,192,0,quiz5,90,100,10
21C8,2016,Spring,192,0,quiz5,90,100,10
31A05,2016,Spring,MATH 2204,0,quiz1,90,100,10
23B14,2016,Fall,MAT192,1,Quiz3,90,100,10
23B14,2016,Fall,MAT192,1,Quiz4,90,100,10
11A12,2016,Spring,Math 1111,1,Quiz3,90,100,10
21A4,2016,Spring,191,1,quiz4,90,100,10
21B10,2016,Spring,192,1,quiz1,90,100,10
21B18,2016,Spring,192,1,quiz2,90,100,10
21B21,2016,Spring,192,1,quiz5,90,100,10
21B28,2016,Spring,192,1,quiz2,90,100,10
21B5,2016,Spring,192,1,quiz6,90,100,10
21D1,2016,Spring,320,1,test3,90,100,10
21D11,2016,Spring,320,1,quiz1,90,100,10
21D8,2016,Spring,320,1,quiz1,90,100,10
31A03,2016,Spring,MATH 2204,1,quiz1,90,100,10
31A03,2016,Spring,MATH 2204,1,quiz2,90,100,10
31A03,2016,Spring,MATH 2204,1,quiz3,90,100,10
31A14,2016,Spring,MATH 2204,1,quiz1,90,100,10
13A6,2016,Fall,Math1113,1,Quiz2,91,100,9
13A6,2016,Fall,Math1113,1,Quiz5,91,100,9
13A6,2016,Fall,Math1113,1,Test2,91,100,9
23A5,2016,Fall,MAT192,0,Test2,92,100,8
23B13,2016,Fall,MAT192,0,Test2,92,100,8
41A37,2016,Spring,MATH3322,1,Final,92,100,8
21C3,2016,Spring,192,1,final,93,100,7
21D17,2016,Spring,320,1,test1,94,100,6
13B15,2016,Fall,Math3650,0,Quiz6,95,100,5
13B15,2016,Fall,Math3650,0,Test3,95,100,5
11A1,2016,Spring,Math 1111,0,Quiz4,95,100,5
11A6,2016,Spring,Math 1111,0,Quiz4,95,100,5
11A7,2016,Spring,Math 1111,0,Quiz4,95,100,5
11C6,2016,Spring,Math 2470,0,test3,95,100,5
13B6,2016,Fall,Math3650,1,Final,95,100,5
23B10,2016,Fall,MAT192,1,Test1,95,100,5
23B6,2016,Fall,MAT192,1,Test3,95,100,5
23B6,2016,Fall,MAT192,1,Final,95,100,5
11A13,2016,Spring,Math 1111,1,Quiz3,95,100,5
11C22,2016,Spring,Math 2470,1,test3,95,100,5
11C26,2016,Spring,Math 2470,1,test3,95,100,5
21C21,2016,Spring,192,1,test1,95,100,5
21D1,2016,Spring,320,1,test1,95,100,5
21D1,2016,Spring,320,1,test2,95,100,5
41A37,2016,Spring,MATH3318,1,test2,95,100,5
11A8,2016,Spring,Math 1111,0,Quiz4,98,100,2
23A3,2016,Fall,MAT192,1,Test3,99,100,1
23A14,2016,Fall,MAT192,0,Quiz1,100,100,0
23A14,2016,Fall,MAT192,0,Quiz3,100,100,0
23A14,2016,Fall,MAT192,0,Quiz5,100,100,0
23A14,2016,Fall,MAT192,0,Quiz7,100,100,0
23A18,2016,Fall,MAT192,0,Quiz3,100,100,0
23A18,2016,Fall,MAT192,0,Quiz4,100,100,0
23A8,2016,Fall,MAT192,0,Quiz1,100,100,0
23A8,2016,Fall,MAT192,0,Quiz8,100,100,0
23B13,2016,Fall,MAT192,0,Quiz1,100,100,0
23B13,2016,Fall,MAT192,0,Quiz6,100,100,0
23B13,2016,Fall,MAT192,0,Quiz7,100,100,0
21A1,2016,Spring,191,0,quiz4,100,100,0
21A1,2016,Spring,191,0,quiz9,100,100,0
21A2,2016,Spring,191,0,quiz3,100,100,0
21A2,2016,Spring,191,0,quiz9,100,100,0
21A3,2016,Spring,191,0,quiz7,100,100,0
21A6,2016,Spring,191,0,quiz3,100,100,0
21A6,2016,Spring,191,0,quiz8,100,100,0
21A6,2016,Spring,191,0,quiz9,100,100,0
21B1,2016,Spring,192,0,quiz2,100,100,0
21B1,2016,Spring,192,0,quiz4,100,100,0
21B1,2016,Spring,192,0,quiz5,100,100,0
21B1,2016,Spring,192,0,quiz6,100,100,0
21B14,2016,Spring,192,0,quiz4,100,100,0
21B14,2016,Spring,192,0,quiz6,100,100,0
21B19,2016,Spring,192,0,quiz5,100,100,0
21B22,2016,Spring,192,0,quiz4,100,100,0
21B22,2016,Spring,192,0,quiz6,100,100,0
21B26,2016,Spring,192,0,quiz2,100,100,0
21B26,2016,Spring,192,0,quiz4,100,100,0
21C10,2016,Spring,192,0,quiz4,100,100,0
21C10,2016,Spring,192,0,quiz5,100,100,0
21C12,2016,Spring,192,0,quiz1,100,100,0
21C12,2016,Spring,192,0,quiz2,100,100,0
21C12,2016,Spring,192,0,quiz4,100,100,0
21C14,2016,Spring,192,0,quiz4,100,100,0
21C14,2016,Spring,192,0,quiz5,100,100,0
21C15,2016,Spring,192,0,quiz2,100,100,0
21C15,2016,Spring,192,0,quiz4,100,100,0
21C16,2016,Spring,192,0,quiz4,100,100,0
21C16,2016,Spring,192,0,quiz5,100,100,0
21C19,2016,Spring,192,0,quiz1,100,100,0
21C19,2016,Spring,192,0,quiz4,100,100,0
21C19,2016,Spring,192,0,quiz5,100,100,0
21C19,2016,Spring,192,0,quiz6,100,100,0
21C22,2016,Spring,192,0,quiz4,100,100,0
21C23,2016,Spring,192,0,quiz1,100,100,0
21C23,2016,Spring,192,0,quiz2,100,100,0
21C23,2016,Spring,192,0,quiz4,100,100,0
21C5,2016,Spring,192,0,quiz2,100,100,0
21C5,2016,Spring,192,0,quiz5,100,100,0
21C5,2016,Spring,192,0,quiz6,100,100,0
21C6,2016,Spring,192,0,quiz4,100,100,0
21C8,2016,Spring,192,0,quiz1,100,100,0
21C8,2016,Spring,192,0,quiz4,100,100,0
21D14,2016,Spring,320,0,quiz1,100,100,0
21D14,2016,Spring,320,0,quiz3,100,100,0
21D14,2016,Spring,320,0,quiz6,100,100,0
21D14,2016,Spring,320,0,test1,100,100,0
21D14,2016,Spring,320,0,test2,100,100,0
21D14,2016,Spring,320,0,test3,100,100,0
21D2,2016,Spring,320,0,quiz1,100,100,0
21D2,2016,Spring,320,0,quiz3,100,100,0
21D2,2016,Spring,320,0,quiz6,100,100,0
31A01,2016,Spring,MATH 2204,0,quiz1,100,100,0
31A01,2016,Spring,MATH 2204,0,quiz3,100,100,0
31A02,2016,Spring,MATH 2204,0,quiz3,100,100,0
31A05,2016,Spring,MATH 2204,0,quiz2,100,100,0
31A08,2016,Spring,MATH 2204,0,quiz1,100,100,0
31A08,2016,Spring,MATH 2204,0,quiz2,100,100,0
31A08,2016,Spring,MATH 2204,0,quiz3,100,100,0
31A13,2016,Spring,MATH 2204,0,quiz2,100,100,0
31A13,2016,Spring,MATH 2204,0,quiz3,100,100,0
31B10,2016,Spring,MATH 2204,0,quiz1,100,100,0
31B18,2016,Spring,MATH 2204,0,quiz1,100,100,0
31B23,2016,Spring,MATH 2204,0,quiz1,100,100,0
41A28,2016,Spring,MATH1120,0,test1,100,100,0
13B6,2016,Fall,Math3650,1,Final,100,100,0
23A10,2016,Fall,MAT192,1,Quiz3,100,100,0
23A19,2016,Fall,MAT192,1,Quiz1,100,100,0
23A19,2016,Fall,MAT192,1,Quiz3,100,100,0
23A19,2016,Fall,MAT192,1,Quiz6,100,100,0
23A19,2016,Fall,MAT192,1,Quiz7,100,100,0
23A3,2016,Fall,MAT192,1,Quiz1,100,100,0
23A3,2016,Fall,MAT192,1,Quiz2,100,100,0
23A3,2016,Fall,MAT192,1,Quiz3,100,100,0
23A3,2016,Fall,MAT192,1,Quiz5,100,100,0
23A7,2016,Fall,MAT192,1,Quiz1,100,100,0
23B10,2016,Fall,MAT192,1,Quiz1,100,100,0
23B10,2016,Fall,MAT192,1,Quiz2,100,100,0
23B2,2016,Fall,MAT192,1,Quiz1,100,100,0
23B2,2016,Fall,MAT192,1,Quiz2,100,100,0
23B2,2016,Fall,MAT192,1,Quiz3,100,100,0
23B6,2016,Fall,MAT192,1,Quiz1,100,100,0
23B6,2016,Fall,MAT192,1,Quiz3,100,100,0
23B6,2016,Fall,MAT192,1,Quiz7,100,100,0
23B6,2016,Fall,MAT192,1,Quiz8,100,100,0
11C25,2016,Spring,Math 2470,1,test3,100,100,0
21A4,2016,Spring,191,1,quiz3,100,100,0
21A4,2016,Spring,191,1,quiz5,100,100,0
21A4,2016,Spring,191,1,quiz6,100,100,0
21A4,2016,Spring,191,1,quiz7,100,100,0
21A5,2016,Spring,191,1,quiz3,100,100,0
21A5,2016,Spring,191,1,quiz4,100,100,0
21A5,2016,Spring,191,1,quiz6,100,100,0
21A5,2016,Spring,191,1,quiz8,100,100,0
21A5,2016,Spring,191,1,quiz9,100,100,0
21A7,2016,Spring,191,1,quiz2,100,100,0
21A7,2016,Spring,191,1,quiz9,100,100,0
21B10,2016,Spring,192,1,quiz2,100,100,0
21B10,2016,Spring,192,1,quiz3,100,100,0
21B10,2016,Spring,192,1,quiz5,100,100,0
21B10,2016,Spring,192,1,quiz6,100,100,0
21B11,2016,Spring,192,1,quiz3,100,100,0
21B11,2016,Spring,192,1,quiz4,100,100,0
21B11,2016,Spring,192,1,quiz5,100,100,0
21B11,2016,Spring,192,1,quiz6,100,100,0
21B12,2016,Spring,192,1,quiz3,100,100,0
21B12,2016,Spring,192,1,quiz4,100,100,0
21B12,2016,Spring,192,1,quiz5,100,100,0
21B15,2016,Spring,192,1,quiz1,100,100,0
21B15,2016,Spring,192,1,quiz2,100,100,0
21B15,2016,Spring,192,1,quiz3,100,100,0
21B15,2016,Spring,192,1,quiz4,100,100,0
21B15,2016,Spring,192,1,quiz5,100,100,0
21B16,2016,Spring,192,1,quiz4,100,100,0
21B18,2016,Spring,192,1,quiz4,100,100,0
21B2,2016,Spring,192,1,quiz3,100,100,0
21B2,2016,Spring,192,1,quiz5,100,100,0
21B23,2016,Spring,192,1,quiz1,100,100,0
21B23,2016,Spring,192,1,quiz3,100,100,0
21B23,2016,Spring,192,1,quiz4,100,100,0
21B23,2016,Spring,192,1,quiz5,100,100,0
21B28,2016,Spring,192,1,quiz4,100,100,0
21B28,2016,Spring,192,1,quiz6,100,100,0
21B29,2016,Spring,192,1,quiz1,100,100,0
21B29,2016,Spring,192,1,quiz4,100,100,0
21B29,2016,Spring,192,1,quiz5,100,100,0
21B29,2016,Spring,192,1,quiz6,100,100,0
21B4,2016,Spring,192,1,quiz4,100,100,0
21B4,2016,Spring,192,1,quiz5,100,100,0
21B5,2016,Spring,192,1,quiz5,100,100,0
21B7,2016,Spring,192,1,quiz2,100,100,0
21B7,2016,Spring,192,1,quiz3,100,100,0
21B7,2016,Spring,192,1,quiz4,100,100,0
21B7,2016,Spring,192,1,quiz5,100,100,0
21B8,2016,Spring,192,1,quiz2,100,100,0
21B9,2016,Spring,192,1,quiz4,100,100,0
21C1,2016,Spring,192,1,quiz4,100,100,0
21C11,2016,Spring,192,1,quiz1,100,100,0
21C11,2016,Spring,192,1,quiz2,100,100,0
21C11,2016,Spring,192,1,quiz4,100,100,0
21C17,2016,Spring,192,1,quiz2,100,100,0
21C17,2016,Spring,192,1,quiz4,100,100,0
21C18,2016,Spring,192,1,quiz1,100,100,0
21C18,2016,Spring,192,1,quiz2,100,100,0
21C18,2016,Spring,192,1,quiz4,100,100,0
21C20,2016,Spring,192,1,quiz4,100,100,0
21C21,2016,Spring,192,1,quiz1,100,100,0
21C21,2016,Spring,192,1,quiz2,100,100,0
21C21,2016,Spring,192,1,quiz4,100,100,0
21C21,2016,Spring,192,1,quiz5,100,100,0
21C3,2016,Spring,192,1,quiz5,100,100,0
21C3,2016,Spring,192,1,quiz6,100,100,0
21C7,2016,Spring,192,1,quiz1,100,100,0
21C7,2016,Spring,192,1,quiz4,100,100,0
21C7,2016,Spring,192,1,quiz5,100,100,0
21C9,2016,Spring,192,1,quiz4,100,100,0
21D1,2016,Spring,320,1,quiz1,100,100,0
21D1,2016,Spring,320,1,quiz4,100,100,0
21D1,2016,Spring,320,1,quiz6,100,100,0
21D10,2016,Spring,320,1,quiz6,100,100,0
21D12,2016,Spring,320,1,quiz1,100,100,0
21D12,2016,Spring,320,1,quiz6,100,100,0
21D13,2016,Spring,320,1,quiz1,100,100,0
21D13,2016,Spring,320,1,quiz6,100,100,0
21D16,2016,Spring,320,1,quiz1,100,100,0
21D16,2016,Spring,320,1,quiz6,100,100,0
21D16,2016,Spring,320,1,test1,100,100,0
21D16,2016,Spring,320,1,test3,100,100,0
21D17,2016,Spring,320,1,quiz1,100,100,0
21D17,2016,Spring,320,1,quiz4,100,100,0
21D17,2016,Spring,320,1,quiz6,100,100,0
21D17,2016,Spring,320,1,test2,100,100,0
21D7,2016,Spring,320,1,quiz4,100,100,0
21D7,2016,Spring,320,1,quiz6,100,100,0
21D9,2016,Spring,320,1,quiz1,100,100,0
31A15,2016,Spring,MATH 2204,1,quiz2,100,100,0
31A16,2016,Spring,MATH 2204,1,quiz1,100,100,0
31A16,2016,Spring,MATH 2204,1,quiz3,100,100,0
31B11,2016,Spring,MATH 2204,1,quiz1,100,100,0
31B21,2016,Spring,MATH 2204,1,quiz1,100,100,0
31B22,2016,Spring,MATH 2204,1,quiz1,100,100,0
31C01,2016,Spring,MATH 2222,1,quiz1,100,100,0
